EthiopianMonth,EthMonNum,EthYear,RegionName,ZoneName,WoredaName,DeliveredPrivateClinics,DeliveredPublicClinics,DeliveredOther,DeliveredTotal
Ginbot,9th,2009,Oromia,East Wellega,Guto Gida,20,16,29,65
Tir,5th,2010,Oromia,Guji,Adola Reda,31,34,69,134
Tahesas,4th,2011,Oromia,Borena,Yabelo Rural,0,18,16,34
Hedar,3rd,2010,Oromia,North Shewa,Kimbibit,33,68,58,159
Ginbot,9th,2009,Oromia,Jimma,Nono Benja,64,45,12,121
Sene,10th,2010,Oromia,Arsi,Aseko,39,70,10,119
Hedar,3rd,2011,Oromia,West Wellega,Nejo Town,74,63,57,194
Megabit,7th,2009,Oromia,Borena,El Way,12,14,43,69
Nehase,12th,2009,Oromia,West Guji,Bule Hora,43,18,42,103
Ginbot,9th,2011,Oromia,Borena,Moyale,83,94,89,266
Yekatit,6th,2011,Oromia,West Wellega,Gimbi Public  Hospital,94,18,47,159
Meskerem,1st,2010,Oromia,East Hararge,Gole Oda,94,85,52,231
Hedar,3rd,2011,Oromia,Woliso Town,Woliso Town,46,63,20,129
Miyazia,8th,2010,Oromia,Arsi,Gololcha,72,53,84,209
Sene,10th,2010,Oromia,Qeleme Wellega,Gawo Qebe,84,69,79,232
Meskerem,1st,2010,Oromia,Finfine Zuria,Walmera,27,40,21,88
Tir,5th,2011,Oromia,East Wellega,Leqa Dulecha,76,91,6,173
Ginbot,9th,2011,Oromia,West Shewa,Gojo Hospital,63,94,43,200
Meskerem,1st,2011,Oromia,East Hararge,Haromaya Rural,91,84,67,242
Yekatit,6th,2010,Oromia,West Guji,Abaya,35,30,55,120
Nehase,12th,2010,Oromia,Guji,Bore Hospital,44,30,51,125
Megabit,7th,2009,Oromia,East Wellega,Guto Gida,90,30,15,135
Hamle,11th,2010,Oromia,Borena,Moyale Hospital,86,99,59,244
Miyazia,8th,2009,Oromia,Burayu Town,Burayu Town,63,48,6,117
Miyazia,8th,2011,Oromia,West Shewa,Chelia,91,14,84,189
Hedar,3rd,2010,Oromia,Qeleme Wellega,Dale Sedi,77,82,77,236
Tir,5th,2011,Oromia,Qeleme Wellega,Hawa Gelan Hosp,0,66,32,98
Megabit,7th,2009,Oromia,East Shewa,Fentale,66,35,15,116
Tahesas,4th,2010,Oromia,Horo Gudru Wellega,Amuru,50,50,23,123
Sene,10th,2009,Oromia,Finfine Zuria,Akaki,84,39,73,196
Hedar,3rd,2011,Oromia,West Wellega,Yubdo,98,9,21,128
Yekatit,6th,2009,Oromia,West Shewa,Ejersa Lafo,70,59,73,202
Tahesas,4th,2010,Oromia,West Hararge,Tulo,63,49,8,120
Tahesas,4th,2011,Oromia,North Shewa,Kuyu,29,96,57,182
Nehase,12th,2009,Oromia,West Wellega,Mendi Town,79,11,91,181
Nehase,12th,2010,Oromia,East Hararge,Chinakesen,1,26,91,118
Meskerem,1st,2010,Oromia,West Hararge,Tulo,56,47,13,116
Hedar,3rd,2010,Oromia,Arsi,Enkelo Wabe,27,61,41,129
Sene,10th,2011,Oromia,Borena,Moyale,2,88,48,138
Hamle,11th,2010,Oromia,Modjo Town,Modjo Town,91,0,24,115
Nehase,12th,2009,Oromia,East Shewa,Boset,44,68,5,117
Yekatit,6th,2009,Oromia,Arsi,Deksis,89,50,98,237
Meskerem,1st,2010,Oromia,Guji,Girja,43,39,17,99
Hedar,3rd,2010,Oromia,West Wellega,Guliso,31,35,21,87
Hedar,3rd,2010,Oromia,West Wellega,Jarso,71,66,6,143
Tahesas,4th,2010,Oromia,West Wellega,Gimbi Adventist Hospital,3,16,19,38
Tir,5th,2009,Oromia,West Shewa,Ejersa Lafo,9,38,79,126
Tahesas,4th,2011,Oromia,Bale,Goba Town,16,6,3,25
Nehase,12th,2009,Oromia,Bale,Goba Town,5,38,32,75
Yekatit,6th,2011,Oromia,West Shewa,Tibe Kutaye,91,59,4,154
Tir,5th,2010,Oromia,East Wellega,Leqa Dulecha,99,72,18,189
Tir,5th,2011,Oromia,South West Shewa,St.Luke Hospital,63,71,88,222
Yekatit,6th,2009,Oromia,West Shewa,Midakegni,39,81,94,214
Sene,10th,2010,Oromia,West Shewa,Codi,69,72,56,197
Tir,5th,2011,Oromia,West Shewa,Adea Berga,73,34,92,199
Tir,5th,2010,Oromia,Horo Gudru Wellega,Gudru,74,31,13,118
Tir,5th,2011,Oromia,East Wellega,Boneya Bushe,89,18,7,114
Tir,5th,2009,Oromia,Ilu Aba Bora,Bilonopa,12,42,10,64
Yekatit,6th,2010,Oromia,West Arsi,Adaba,10,97,78,185
Hedar,3rd,2010,Oromia,South West Shewa,St.Luke Hospital,38,77,67,182
Meskerem,1st,2010,Oromia,Finfine Zuria,Berreh,15,33,67,115
Tir,5th,2010,Oromia,West Shewa,Ejersa Lafo,41,98,26,165
Nehase,12th,2010,Oromia,Jimma,Gera,18,29,87,134
Ginbot,9th,2011,Oromia,Guji,Aga Wayyu,85,36,18,139
Teqemt,2nd,2010,Oromia,West Hararge,Meiso,92,6,0,98
Sene,10th,2009,Oromia,Bale,Meda Welabu,80,15,47,142
Nehase,12th,2009,Oromia,Bale,Raitu,59,8,90,157
Yekatit,6th,2009,Oromia,Bale,Goro,24,86,81,191
Tahesas,4th,2011,Oromia,Lege Dadi Lege Tafo Town,Lege Dadi Lege Tafo Town,6,67,15,88
Megabit,7th,2009,Oromia,West Wellega,Nejo Rural,47,72,0,119
Meskerem,1st,2010,Oromia,Buno Bedele,Diga,98,54,45,197
Ginbot,9th,2010,Oromia,West Shewa,Midakegni,60,49,65,174
Sene,10th,2010,Oromia,West Shewa,Ilu Galan,64,50,90,204
Sene,10th,2009,Oromia,Borena,Guchi,74,18,16,108
Tir,5th,2011,Oromia,Horo Gudru Wellega,Hababo Guduru,47,0,91,138
Megabit,7th,2010,Oromia,West Wellega,Begi Hospital,40,89,19,148
Ginbot,9th,2010,Oromia,Dukem Town,Dukem Town,2,72,48,122
Sene,10th,2010,Oromia,West Shewa,Dendi,14,2,81,97
Yekatit,6th,2010,Oromia,Jimma,Omonada,14,69,14,97
Ginbot,9th,2010,Oromia,Guji,Goro Dola,57,95,6,158
Teqemt,2nd,2011,Oromia,South West Shewa,Ameya,83,27,15,125
Meskerem,1st,2011,Oromia,West Wellega,Nejo Town,57,33,25,115
Teqemt,2nd,2010,Oromia,Arsi,Merti,65,62,82,209
Teqemt,2nd,2010,Oromia,East Hararge,Girawa,15,98,99,212
Miyazia,8th,2010,Oromia,Arsi,Ludehetosa,37,3,51,91
Tahesas,4th,2011,Oromia,Bale,Legehida,11,1,25,37
Tir,5th,2011,Oromia,West Arsi,Gedeb Asasa,37,9,2,48
Sene,10th,2009,Oromia,Arsi,Aseko,5,1,43,49
Miyazia,8th,2010,Oromia,Qeleme Wellega,Yemalogi Wolel,93,83,36,212
Miyazia,8th,2011,Oromia,East Shewa,Bora,84,96,65,245
Tir,5th,2010,Oromia,East Hararge,Kombolicha,18,55,35,108
Megabit,7th,2009,Oromia,Qeleme Wellega,Dambi Dollo,40,93,64,197
Tir,5th,2010,Oromia,Jimma,Limu Hospital,54,63,20,137
Hedar,3rd,2011,Oromia,West Arsi,Shala,74,62,71,207
Teqemt,2nd,2010,Oromia,North Shewa,Were Jarso,22,36,52,110
Ginbot,9th,2011,Oromia,Ilu Aba Bora,Metu Town,66,89,53,208
Meskerem,1st,2011,Oromia,West Shewa,Ambo Hospital,30,14,22,66
Yekatit,6th,2010,Oromia,South West Shewa,Sodo Dac'Ha,40,83,51,174
Nehase,12th,2010,Oromia,Bale,Gasera,30,22,53,105
Sene,10th,2011,Oromia,West Shewa,Nono,9,98,12,119
Miyazia,8th,2011,Oromia,North Shewa,Were Jarso,33,11,99,143
Yekatit,6th,2010,Oromia,East Shewa,Fentale,25,76,4,105
Miyazia,8th,2011,Oromia,Jimma,Omo Nada Hospital,97,79,41,217
Meskerem,1st,2011,Oromia,Jimma,Gera,71,42,65,178
Teqemt,2nd,2011,Oromia,Finfine Zuria,Berreh,40,62,31,133
Miyazia,8th,2009,Oromia,South West Shewa,Sodo Dac'Ha,49,79,44,172
Ginbot,9th,2009,Oromia,North Shewa,Kuyu,69,12,3,84
Tir,5th,2010,Oromia,Jimma Spe Town,Jimma Spe Town,66,13,98,177
Sene,10th,2010,Oromia,Bale,Legehida,5,90,82,177
Hedar,3rd,2011,Oromia,West Guji,Bule Hora,35,89,29,153
Ginbot,9th,2011,Oromia,Qeleme Wellega,Laloqile,7,23,91,121
Hedar,3rd,2010,Oromia,Bale,Gura Dhamole,17,78,80,175
Meskerem,1st,2011,Oromia,South West Shewa,Tole,9,62,66,137
Teqemt,2nd,2010,Oromia,West Hararge,Chiro Town,78,31,61,170
Sene,10th,2009,Oromia,Guji,Negele Hospital,25,74,97,196
Ginbot,9th,2011,Oromia,Jimma,Seka Chekorsa,25,14,78,117
Megabit,7th,2010,Oromia,Lege Dadi Lege Tafo Town,Lege Dadi Lege Tafo Town,4,26,42,72
Yekatit,6th,2010,Oromia,Borena,Dubluk,71,95,11,177
Tir,5th,2009,Oromia,Ilu Aba Bora,Didu,30,19,72,121
Nehase,12th,2010,Oromia,Bale,Legehida,46,4,7,57
Hamle,11th,2010,Oromia,East Wellega,Gobu Seyo,83,14,34,131
Yekatit,6th,2010,Oromia,Arsi,Zeway Dugda,31,55,61,147
Megabit,7th,2010,Oromia,East Hararge,Garemuleta Hospital,42,12,31,85
Hamle,11th,2009,Oromia,Guji,Shakiso Town,17,58,16,91
Tir,5th,2011,Oromia,West Hararge,Chiro Hospital,92,13,30,135
Sene,10th,2009,Oromia,West Hararge,West Harerge	Gumbi Bordede,3,82,86,171
Meskerem,1st,2010,Oromia,East Hararge,Deder Town,4,57,80,141
Tahesas,4th,2010,Oromia,Arsi,Ludehetosa,9,14,73,96
Sene,10th,2009,Oromia,Bale,Goba Town,62,84,90,236
Ginbot,9th,2009,Oromia,Arsi,Bale Gesgara,38,57,91,186
Yekatit,6th,2009,Oromia,Ilu Aba Bora,Halu,2,90,16,108
Tir,5th,2010,Oromia,Arsi,Zeway Dugda,9,3,57,69
Tir,5th,2010,Oromia,Jimma,B/Tolyi,9,81,53,143
Ginbot,9th,2010,Oromia,Jimma Spe Town,Jimma Spe Town,1,41,98,140
Tahesas,4th,2010,Oromia,North Shewa,Aleiltu,28,14,41,83
Yekatit,6th,2010,Oromia,Qeleme Wellega,Gawo Qebe,47,61,44,152
Nehase,12th,2010,Oromia,Horo Gudru Wellega,Gudru,48,90,32,170
Sene,10th,2009,Oromia,Bale,Agarfa,0,73,15,88
Teqemt,2nd,2011,Oromia,West Hararge,Burka Dimtu,90,52,26,168
Yekatit,6th,2011,Oromia,North Shewa,Girar Jarso,43,43,67,153
Hamle,11th,2009,Oromia,South West Shewa,Wonchi,24,79,54,157
Tahesas,4th,2011,Oromia,East Hararge,Bedeno,55,18,87,160
Tahesas,4th,2010,Oromia,Finfine Zuria,Walmera,86,46,84,216
Sene,10th,2011,Oromia,East Wellega,Gobu Seyo,15,75,9,99
Sene,10th,2010,Oromia,Buno Bedele,Boricha,72,18,77,167
Miyazia,8th,2009,Oromia,South West Shewa,Dawo,87,29,16,132
Hamle,11th,2009,Oromia,West Guji,Kercha Hospital,85,77,6,168
Meskerem,1st,2011,Oromia,West Shewa,Dano,83,99,37,219
Nehase,12th,2009,Oromia,North Shewa,Jido,8,99,14,121
Sene,10th,2009,Oromia,Jimma,Limu Seka,67,35,81,183
Miyazia,8th,2010,Oromia,West Hararge,Doba,8,0,10,18
Hamle,11th,2010,Oromia,Jimma,Seka Chhokorsa Hospital,39,8,76,123
Miyazia,8th,2009,Oromia,North Shewa,Kuyu,18,99,52,169
Hedar,3rd,2011,Oromia,North Shewa,Kuyu Hospital,4,18,3,25
Teqemt,2nd,2011,Oromia,Qeleme Wellega,Anfilo,91,80,13,184
Megabit,7th,2010,Oromia,North Shewa,Fiche Hospital,74,5,21,100
Hedar,3rd,2011,Oromia,West Wellega,Seyo Nole,31,8,0,39
Tahesas,4th,2010,Oromia,Jimma,Nono Benja,96,62,17,175
Ginbot,9th,2009,Oromia,Arsi,Sude,23,51,21,95
Yekatit,6th,2009,Oromia,East Hararge,Bisidimo Hospital,91,44,89,224
Ginbot,9th,2010,Oromia,Ilu Aba Bora,Darimu,56,68,24,148
Tir,5th,2011,Oromia,East Wellega,Boneya Bushe,81,43,47,171
Miyazia,8th,2009,Oromia,East Hararge,Midega Tole,98,61,88,247
Yekatit,6th,2009,Oromia,Jimma,Nono Benja,58,67,23,148
Megabit,7th,2011,Oromia,West Wellega,Guliso,7,83,76,166
Ginbot,9th,2011,Oromia,Guji,Wadara,78,23,47,148
Ginbot,9th,2010,Oromia,West Wellega,Lata Sibu,85,98,43,226
Ginbot,9th,2009,Oromia,Buno Bedele,Dapho Hana,80,89,64,233
Hedar,3rd,2010,Oromia,West Wellega,Nole Kaba,52,34,67,153
Megabit,7th,2010,Oromia,East Wellega,Nunu Qumba,84,10,90,184
Ginbot,9th,2009,Oromia,Arsi,Merti,62,77,98,237
Tahesas,4th,2010,Oromia,Buno Bedele,Bedele Zuriya,59,56,16,131
Hedar,3rd,2011,Oromia,Borena,Guchi,61,50,0,111
Ginbot,9th,2009,Oromia,Finfine Zuria,Walmera,25,94,20,139
Ginbot,9th,2010,Oromia,Qeleme Wellega,Gawo Qebe,0,39,27,66
Miyazia,8th,2009,Oromia,West Shewa,Jibat,50,19,53,122
Teqemt,2nd,2010,Oromia,East Shewa,Fentale,36,10,42,88
Hamle,11th,2010,Oromia,Adama Special Town,Adama Town,5,47,47,99
Nehase,12th,2010,Oromia,Ilu Aba Bora,Metu Rural,45,1,63,109
Hedar,3rd,2011,Oromia,East Hararge,Deder Town,30,76,93,199
Hedar,3rd,2010,Oromia,Assela Town,Assela Town,57,58,2,117
Megabit,7th,2009,Oromia,West Wellega,Genji,50,67,57,174
Tir,5th,2010,Oromia,East Wellega,Kiremu,64,66,30,160
Nehase,12th,2009,Oromia,West Hararge,Oda Bultum,51,3,33,87
Miyazia,8th,2009,Oromia,East Shewa,Bora,55,3,73,131
Nehase,12th,2009,Oromia,Guji,Adola Reda,43,84,63,190
Hedar,3rd,2010,Oromia,East Shewa,Matahara,46,59,44,149
Tir,5th,2011,Oromia,West Wellega,Mene Sibu,87,56,71,214
Tahesas,4th,2010,Oromia,Bale,Ginir,40,83,65,188
Tahesas,4th,2011,Oromia,Guji,Hambela Wamena,4,75,94,173
Yekatit,6th,2009,Oromia,West Hararge,Gelemso Hospital,35,37,23,95
Tahesas,4th,2010,Oromia,North Shewa,Aleiltu,67,25,37,129
Tahesas,4th,2010,Oromia,Jimma,Shabe,18,29,2,49
Nehase,12th,2010,Oromia,Jimma,Tiro Afeta,42,21,81,144
Ginbot,9th,2010,Oromia,East Wellega,Haro Limu,4,0,34,38
Nehase,12th,2009,Oromia,Horo Gudru Wellega,Shambu Hospital,64,51,27,142
Nehase,12th,2010,Oromia,Arsi,Tena,11,80,68,159
Hedar,3rd,2010,Oromia,Arsi,Deksis,7,97,2,106
Sene,10th,2009,Oromia,West Arsi,Wondo,36,54,50,140
Teqemt,2nd,2010,Oromia,Ilu Aba Bora,Darimu,83,3,9,95
Yekatit,6th,2010,Oromia,West Wellega,Nejo Rural,62,75,97,234
Tir,5th,2010,Oromia,Shashamane Town,Shashamane Town,28,31,18,77
Hamle,11th,2009,Oromia,Borena,El Way,36,85,49,170
Sene,10th,2011,Oromia,West Hararge,Oda Bultum,14,96,7,117
Teqemt,2nd,2011,Oromia,East Hararge,Jarso,53,92,6,151
Meskerem,1st,2011,Oromia,South West Shewa,Ameya Hospital,35,55,22,112
Miyazia,8th,2010,Oromia,Guji,Hambela Wamena,66,90,71,227
Hedar,3rd,2011,Oromia,West Wellega,Lalo Asabi,53,39,17,109
Yekatit,6th,2010,Oromia,West Shewa,Ejersa Lafo,50,74,94,218
Megabit,7th,2009,Oromia,Buno Bedele,Chora,50,7,91,148
Tahesas,4th,2011,Oromia,West Wellega,Gimbi Adventist Hospital,50,44,0,94
Tir,5th,2011,Oromia,West Shewa,Ejerie,66,27,71,164
Sene,10th,2009,Oromia,Arsi,Robe,29,14,92,135
Tahesas,4th,2011,Oromia,Arsi,Deksis,15,43,36,94
Nehase,12th,2009,Oromia,Jimma,Omonada,57,40,77,174
Hedar,3rd,2010,Oromia,West Arsi,Bishan Guracha Town,0,41,71,112
Ginbot,9th,2011,Oromia,East Hararge,Haromaya Town,56,54,12,122
Hedar,3rd,2010,Oromia,Horo Gudru Wellega,Hababo Guduru,62,83,44,189
Tahesas,4th,2010,Oromia,Arsi,Digeluna Tijo,33,78,17,128
Yekatit,6th,2010,Oromia,East Hararge,Deder Hospital,61,11,17,89
Ginbot,9th,2010,Oromia,East Wellega,Boneya Bushe,46,23,4,73
Teqemt,2nd,2011,Oromia,Jimma,Limu Seka,67,18,16,101
Hedar,3rd,2011,Oromia,Jimma,Seka Chekorsa,8,64,66,138
Tahesas,4th,2011,Oromia,Arsi,Bekoji Town,71,93,89,253
Nehase,12th,2009,Oromia,Bale,Raitu,54,65,2,121
Tir,5th,2011,Oromia,Bale,Gasera,37,83,10,130
Tir,5th,2010,Oromia,Ilu Aba Bora,Metu Rural,54,85,83,222
Meskerem,1st,2010,Oromia,Guji,Wadara,63,88,40,191
Ginbot,9th,2010,Oromia,East Wellega,Leqa Dulecha,96,4,72,172
Miyazia,8th,2011,Oromia,Arsi,Tena,66,57,79,202
Sene,10th,2011,Oromia,Ilu Aba Bora,Bure,12,39,64,115
Megabit,7th,2009,Oromia,South West Shewa,Kersana Malima,92,57,32,181
Miyazia,8th,2011,Oromia,East Hararge,Garemuleta Hospital,18,91,75,184
Yekatit,6th,2010,Oromia,Guji,Hambela Wamena,65,33,41,139
Tahesas,4th,2010,Oromia,Borena,Wachile,9,58,42,109
Ginbot,9th,2011,Oromia,West Hararge,Meiso,69,13,7,89
Megabit,7th,2010,Oromia,West Shewa,Tikur Enchini,62,34,73,169
Meskerem,1st,2010,Oromia,North Shewa,Dera Hospital,11,26,38,75
Sene,10th,2010,Oromia,Jimma,Mancho,87,16,42,145
Meskerem,1st,2011,Oromia,West Wellega,Mendi Hospital,11,6,56,73
Nehase,12th,2010,Oromia,Guji,Saba Boru,26,96,89,211
Sene,10th,2009,Oromia,West Shewa,Bako Tibe,71,92,63,226
Teqemt,2nd,2011,Oromia,West Hararge,Gelemso Hospital,43,30,11,84
Ginbot,9th,2009,Oromia,West Guji,Bule Hora,38,89,52,179
Miyazia,8th,2010,Oromia,West Shewa,Dendi,95,78,18,191
Meskerem,1st,2010,Oromia,East Wellega,Gudeyabila,99,1,85,185
Nehase,12th,2009,Oromia,Bale,Delo Mena,99,68,62,229
Meskerem,1st,2011,Oromia,East Hararge,Melka Belo,74,27,52,153
Tahesas,4th,2011,Oromia,Jimma,Chora Boter,97,83,28,208
Megabit,7th,2011,Oromia,East Hararge,Bisidimo Hospital,79,88,25,192
Miyazia,8th,2009,Oromia,South West Shewa,St.Luke Hospital,3,84,63,150
Teqemt,2nd,2010,Oromia,West Shewa,Codi,84,30,3,117
Sene,10th,2009,Oromia,West Arsi,Arsi Negele Town,35,3,31,69
Nehase,12th,2010,Oromia,Ilu Aba Bora,Bilonopa,4,87,26,117
Hedar,3rd,2011,Oromia,West Shewa,Ambo,48,44,55,147
Yekatit,6th,2009,Oromia,Arsi,Bale Gesgara,91,72,26,189
Nehase,12th,2009,Oromia,Jimma,Sigmo,54,86,36,176
Hamle,11th,2010,Oromia,Arsi,Hitosa,61,12,33,106
Sene,10th,2009,Oromia,West Arsi,Gedeb Asasa,16,39,2,57
Megabit,7th,2011,Oromia,West Shewa,Ambo,41,92,9,142
Ginbot,9th,2010,Oromia,West Shewa,Elifata,22,10,38,70
Yekatit,6th,2011,Oromia,East Hararge,Haromaya Rural,0,36,63,99
Hamle,11th,2010,Oromia,Arsi,Zeway Dugda,19,90,93,202
Ginbot,9th,2011,Oromia,Jimma,Mancho,71,79,33,183
Ginbot,9th,2011,Oromia,Finfine Zuria,Sandefa,14,15,93,122
Yekatit,6th,2009,Oromia,East Shewa,Liben,64,84,54,202
Nehase,12th,2009,Oromia,West Hararge,Guba Qoricha,95,55,48,198
Hamle,11th,2010,Oromia,Jimma,Nono Benja,29,46,87,162
Tir,5th,2010,Oromia,Ilu Aba Bora,Halu,77,82,45,204
Meskerem,1st,2011,Oromia,South West Shewa,Wonchi,35,34,26,95
Tahesas,4th,2010,Oromia,South West Shewa,Sodo Dac'Ha,79,97,26,202
Sene,10th,2010,Oromia,West Shewa,Ambo,38,72,27,137
Tahesas,4th,2011,Oromia,Ilu Aba Bora,Doreni,84,86,77,247
Yekatit,6th,2010,Oromia,West Hararge,Chiro Town,59,77,36,172
Tahesas,4th,2011,Oromia,Qeleme Wellega,Sedan Chanka,20,92,51,163
Hamle,11th,2009,Oromia,Guji,Hambela Wamena,92,17,86,195
Teqemt,2nd,2010,Oromia,Arsi,Bekoji Town,89,52,72,213
Hedar,3rd,2010,Oromia,Buno Bedele,Bedele Zuriya,93,95,23,211
Miyazia,8th,2011,Oromia,West Hararge,Chiro Zuriya,68,1,3,72
Hedar,3rd,2010,Oromia,West Guji,Bule Hora Toun,45,13,94,152
Teqemt,2nd,2011,Oromia,Borena,Moyale,95,94,70,259
Megabit,7th,2010,Oromia,Guji,Hambela Wamena,79,43,71,193
Hedar,3rd,2011,Oromia,East Shewa,Gimbichu,13,81,36,130
Sene,10th,2009,Oromia,Adama Special Town,Adama Town,99,74,78,251
Yekatit,6th,2010,Oromia,Jimma,Mana,37,69,28,134
Miyazia,8th,2009,Oromia,East Hararge,Girawa,56,21,16,93
Sene,10th,2011,Oromia,Guji,Adola Hospital,63,19,53,135
Tir,5th,2011,Oromia,Jimma,Sekoru,32,92,40,164
Hedar,3rd,2010,Oromia,Qeleme Wellega,Hawa Gelan,31,24,86,141
Yekatit,6th,2011,Oromia,Bale,Legehida,31,71,8,110
Ginbot,9th,2009,Oromia,Bale,Seweyna,68,16,80,164
Sene,10th,2011,Oromia,West Arsi,Arsi Negele Rural,5,49,36,90
Nehase,12th,2009,Oromia,West Hararge,Bedesa Town,54,61,98,213
Hedar,3rd,2010,Oromia,South West Shewa,Dawo,71,66,39,176
Meskerem,1st,2010,Oromia,West Shewa,Inchini Hospital,64,60,84,208
Ginbot,9th,2011,Oromia,West Wellega,Homa,49,22,56,127
Sene,10th,2009,Oromia,West Guji,Hanbala,70,49,96,215
Tahesas,4th,2011,Oromia,East Hararge,Girawa,18,23,47,88
Hedar,3rd,2011,Oromia,Ilu Aba Bora,Becho,16,82,20,118
Megabit,7th,2010,Oromia,West Shewa,Meta Waliqite,60,43,37,140
Teqemt,2nd,2011,Oromia,Finfine Zuria,Mullo,16,37,39,92
Tahesas,4th,2011,Oromia,Arsi,Digeluna Tijo,17,22,91,130
Sene,10th,2010,Oromia,Qeleme Wellega,Dale Wabera,74,68,65,207
Ginbot,9th,2010,Oromia,South West Shewa,Wonchi,0,64,18,82
Sene,10th,2009,Oromia,Guji,Negele Hospital,78,40,83,201
Hedar,3rd,2011,Oromia,East Shewa,Liben,21,13,46,80
Tahesas,4th,2010,Oromia,Borena,Dilo,50,20,5,75
Sene,10th,2011,Oromia,Guji,Adola Reda,53,96,94,243
Tahesas,4th,2010,Oromia,West Arsi,Bishan Guracha Town,27,98,85,210
Tir,5th,2010,Oromia,Buno Bedele,Gechi,7,11,87,105
Ginbot,9th,2010,Oromia,Guji,Saba Boru,48,87,59,194
Sene,10th,2009,Oromia,Jimma,Gera,99,67,91,257
Nehase,12th,2009,Oromia,South West Shewa,Wonchi,58,86,79,223
Meskerem,1st,2010,Oromia,Horo Gudru Wellega,Shambu Hospital,77,14,28,119
Megabit,7th,2011,Oromia,West Arsi,Arsi Negele Rural,51,51,28,130
Hedar,3rd,2011,Oromia,Ilu Aba Bora,Yayu,83,24,13,120
Teqemt,2nd,2010,Oromia,West Shewa,Elifata,56,57,61,174
Nehase,12th,2010,Oromia,South West Shewa,Ameya,46,10,30,86
Tir,5th,2011,Oromia,West Shewa,Dano,19,99,10,128
Yekatit,6th,2011,Oromia,West Shewa,Ambo Hospital,97,40,95,232
Ginbot,9th,2011,Oromia,East Hararge,Melka Belo,97,91,81,269
Yekatit,6th,2009,Oromia,Buno Bedele,Bedele Hospital,43,74,78,195
Tir,5th,2009,Oromia,North Shewa,Debre Libanos,36,72,12,120
Nehase,12th,2010,Oromia,Buno Bedele,Dapho Hana,8,76,74,158
Sene,10th,2009,Oromia,East Hararge,Deder,17,60,49,126
Yekatit,6th,2009,Oromia,West Wellega,Homa,38,37,78,153
Nehase,12th,2009,Oromia,West Hararge,Gemechis,41,25,66,132
Yekatit,6th,2011,Oromia,West Guji,Bule Hora,25,76,84,185
Ginbot,9th,2009,Oromia,Arsi,Bekoji Town,11,27,42,80
Ginbot,9th,2011,Oromia,East Shewa,Matahara,11,93,58,162
Nehase,12th,2010,Oromia,Guji,Bore Hospital,38,80,19,137
Megabit,7th,2009,Oromia,South West Shewa,St.Luke Hospital,44,5,84,133
Hedar,3rd,2011,Oromia,Bale,Arena Buluq,73,63,28,164
Yekatit,6th,2011,Oromia,West Arsi,Kokosa,71,63,36,170
Tir,5th,2009,Oromia,West Wellega,Haru,28,76,33,137
Hamle,11th,2010,Oromia,East Wellega,Gobu Seyo,61,86,97,244
Megabit,7th,2009,Oromia,Arsi,Guna,61,11,90,162
Miyazia,8th,2011,Oromia,West Guji,Kercha,64,42,65,171
Sene,10th,2010,Oromia,Arsi,Merti,36,96,64,196
Tahesas,4th,2010,Oromia,West Wellega,Nejo Town,35,35,13,83
Miyazia,8th,2010,Oromia,Assela Town,Assela Town,23,0,28,51
Miyazia,8th,2011,Oromia,West Shewa,Dano,46,89,50,185
Tahesas,4th,2010,Oromia,West Shewa,Ambo,7,9,70,86
Meskerem,1st,2011,Oromia,South West Shewa,Kersana Malima,38,85,35,158
Meskerem,1st,2011,Oromia,West Arsi,Dodola Rural,80,6,25,111
Miyazia,8th,2011,Oromia,Bale,Legehida,39,86,38,163
Megabit,7th,2010,Oromia,Buno Bedele,Dedesa,78,93,46,217
Nehase,12th,2009,Oromia,Finfine Zuria,Sebeta Awas,66,78,42,186
Megabit,7th,2011,Oromia,Borena,Dhas,65,1,52,118
Miyazia,8th,2011,Oromia,West Wellega,Genji,29,83,60,172
Hamle,11th,2010,Oromia,Guji,Negele Town,32,49,58,139
Hamle,11th,2010,Oromia,Ilu Aba Bora,Bilonopa,99,96,14,209
Sene,10th,2011,Oromia,West Arsi,Arsi Negele Rural,88,75,96,259
Ginbot,9th,2010,Oromia,West Shewa,Dano,51,0,92,143
Yekatit,6th,2009,Oromia,West Wellega,Gimbi Adventist Hospital,75,59,75,209
Nehase,12th,2009,Oromia,West Hararge,Burka Dimtu,24,86,13,123
Tahesas,4th,2011,Oromia,Guji,Saba Boru,10,27,80,117
Ginbot,9th,2011,Oromia,West Wellega,Gimbi Rural,94,22,24,140
Teqemt,2nd,2011,Oromia,North Shewa,Aleiltu,51,60,36,147
Miyazia,8th,2009,Oromia,West Hararge,Chiro Zuriya,6,33,50,89
Sene,10th,2011,Oromia,East Hararge,Girawa,79,85,60,224
Miyazia,8th,2009,Oromia,Borena,El Way,36,51,11,98
Tir,5th,2010,Oromia,West Hararge,Habro,85,43,75,203
Hedar,3rd,2011,Oromia,Modjo Town,Modjo Town,1,56,87,144
Tir,5th,2011,Oromia,West Wellega,Gimbi Rural,18,34,74,126
Hedar,3rd,2011,Oromia,West Shewa,Elifata,74,10,83,167
Yekatit,6th,2010,Oromia,East Wellega,Leqa Dulecha,19,32,68,119
Hamle,11th,2010,Oromia,Guji,Bore Hospital,16,52,66,134
Hamle,11th,2009,Oromia,Qeleme Wellega,Dambi Dolo Hospital,90,33,8,131
Ginbot,9th,2011,Oromia,West Shewa,Ambo University  Hosp,3,22,2,27
Hamle,11th,2010,Oromia,West Wellega,Gimbi,91,74,97,262
Sene,10th,2009,Oromia,East Shewa,Matahara,84,16,86,186
Tir,5th,2011,Oromia,West Wellega,Nejo Town,56,95,37,188
Megabit,7th,2010,Oromia,Arsi,Dodota,70,0,60,130
Meskerem,1st,2011,Oromia,West Shewa,Ginde Beret,74,48,59,181
Ginbot,9th,2010,Oromia,North Shewa,Kuyu,3,58,55,116
Teqemt,2nd,2010,Oromia,Jimma,Sigmo,71,67,95,233
Sene,10th,2011,Oromia,East Hararge,Goro Muti,96,75,28,199
Nehase,12th,2010,Oromia,Lege Dadi Lege Tafo Town,Lege Dadi Lege Tafo Town,79,81,11,171
Megabit,7th,2010,Oromia,Arsi,Munesa,62,74,33,169
Hamle,11th,2010,Oromia,West Arsi,Arsi Negele Rural,9,26,24,59
Hedar,3rd,2011,Oromia,South West Shewa,Woliso Rural,24,60,95,179
Ginbot,9th,2010,Oromia,Qeleme Wellega,Gawo Qebe,85,78,0,163
Tahesas,4th,2011,Oromia,West Arsi,Kore,20,56,63,139
Meskerem,1st,2010,Oromia,Finfine Zuria,Walmera,27,20,30,77
Megabit,7th,2009,Oromia,Jimma,Chora Boter,61,37,84,182
Miyazia,8th,2011,Oromia,Guji,Odo Shakiso,84,27,42,153
Megabit,7th,2011,Oromia,West Arsi,Shashemene Rural,41,3,41,85
Teqemt,2nd,2011,Oromia,East Shewa,Gimbichu,35,17,37,89
Hamle,11th,2009,Oromia,West Hararge,Daro Lebu,72,33,44,149
Hedar,3rd,2010,Oromia,South West Shewa,Becho,68,72,57,197
Tahesas,4th,2010,Oromia,West Wellega,Mendi Hospital,84,82,83,249
Miyazia,8th,2010,Oromia,West Hararge,Bedesa Town,13,56,43,112
Ginbot,9th,2009,Oromia,West Guji,Abaya,86,94,2,182
Tir,5th,2010,Oromia,East Wellega,Gudeyabila,0,80,70,150
Tahesas,4th,2010,Oromia,Arsi,Hitosa,71,73,1,145
Tahesas,4th,2010,Oromia,East Shewa,Gimbichu,45,98,42,185
Megabit,7th,2009,Oromia,Ilu Aba Bora,Yayu,81,63,54,198
Sene,10th,2009,Oromia,East Wellega,Guto Gida,59,73,25,157
Hamle,11th,2010,Oromia,South West Shewa,Ilu,95,66,19,180
Megabit,7th,2011,Oromia,Finfine Zuria,Sebeta Awas,59,12,7,78
Yekatit,6th,2009,Oromia,Guji,Wadara,77,54,72,203
Miyazia,8th,2011,Oromia,East Hararge,Gole Oda,70,96,51,217
Megabit,7th,2009,Oromia,Buno Bedele,Meko,46,65,29,140
Yekatit,6th,2010,Oromia,West Guji,Abaya,51,62,22,135
Ginbot,9th,2009,Oromia,West Shewa,Gedo Hospital,48,46,12,106
Hamle,11th,2010,Oromia,West Arsi,Nensebo,21,27,4,52
Meskerem,1st,2011,Oromia,Buno Bedele,Bedele Town,30,49,68,147
Hedar,3rd,2010,Oromia,Finfine Zuria,Berreh,86,6,63,155
Hedar,3rd,2010,Oromia,Robe Town,Robe Town,78,60,42,180
Ginbot,9th,2009,Oromia,Bale,Gasera,20,77,52,149
Tahesas,4th,2010,Oromia,Finfine Zuria,Mullo,67,63,98,228
Hedar,3rd,2011,Oromia,West Hararge,Gelemso Hospital,66,57,75,198
Hedar,3rd,2011,Oromia,Ilu Aba Bora,Hurumu,96,10,84,190
Tir,5th,2009,Oromia,Sebeta Town,Sebeta Town,99,73,33,205
Nehase,12th,2009,Oromia,Buno Bedele,Chora,40,86,36,162
Hedar,3rd,2010,Oromia,South West Shewa,Woliso Rural,4,58,54,116
Hamle,11th,2009,Oromia,Bale,Dawe Serar,61,39,62,162
Hedar,3rd,2010,Oromia,East Wellega,Kiremu,92,11,90,193
Hedar,3rd,2010,Oromia,West Shewa,Guder Hosp,77,73,35,185
Ginbot,9th,2009,Oromia,West Arsi,Wondo,92,55,39,186
Hedar,3rd,2010,Oromia,Modjo Town,Modjo Town,42,80,61,183
Megabit,7th,2009,Oromia,Guji,Adola Hospital,22,81,19,122
Hamle,11th,2009,Oromia,East Hararge,Midega Tole,18,85,90,193
Tahesas,4th,2011,Oromia,East Wellega,Sibu Sire,83,95,48,226
Sene,10th,2011,Oromia,East Hararge,Garemuleta Hospital,24,45,16,85
Meskerem,1st,2011,Oromia,Jimma,Shabe,90,24,34,148
Megabit,7th,2010,Oromia,West Arsi,Dodola  Hospital,42,7,6,55
Megabit,7th,2011,Oromia,East Hararge,Babile Woreda,98,99,46,243
Miyazia,8th,2011,Oromia,Buno Bedele,Bedele Town,28,39,46,113
Hedar,3rd,2010,Oromia,Arsi,Limuna Bilbilo,60,0,28,88
Tahesas,4th,2011,Oromia,West Shewa,Gindeberet Hospital,1,96,42,139
Yekatit,6th,2010,Oromia,West Wellega,Seyo Nole,97,52,89,238
Tir,5th,2010,Oromia,Borena,Arero,40,77,40,157
Yekatit,6th,2010,Oromia,Arsi,Shirka,96,50,35,181
Tahesas,4th,2011,Oromia,Jimma,Tiro Afeta,83,94,18,195
Miyazia,8th,2010,Oromia,West Wellega,Ayira Hospital,3,96,78,177
Teqemt,2nd,2010,Oromia,West Hararge,West Harerge	Gumbi Bordede,58,58,58,174
Teqemt,2nd,2011,Oromia,Nekemte Town,Nekemte Town,23,16,7,46
Ginbot,9th,2011,Oromia,Arsi,Tena,86,42,53,181
Ginbot,9th,2010,Oromia,West Arsi,Gedeb Asasa,15,90,69,174
Tir,5th,2009,Oromia,West Guji,Gelana,1,67,44,112
Nehase,12th,2010,Oromia,West Hararge,Meiso,65,21,33,119
Tir,5th,2010,Oromia,Borena,Arero,11,92,25,128
Tahesas,4th,2011,Oromia,West Hararge,Chiro Hospital,68,58,42,168
Hedar,3rd,2010,Oromia,Bale,Seweyna,51,53,70,174
Tahesas,4th,2010,Oromia,West Wellega,Mendi Town,86,74,59,219
Ginbot,9th,2011,Oromia,West Guji,Kercha Hospital,35,88,23,146
Ginbot,9th,2011,Oromia,East Wellega,Wayu Tuqa,41,45,57,143
Meskerem,1st,2011,Oromia,Jimma,Omonada,54,98,84,236
Nehase,12th,2010,Oromia,North Shewa,Were Jarso,4,80,87,171
Hedar,3rd,2011,Oromia,East Wellega,Gobu Seyo,22,84,69,175
Teqemt,2nd,2011,Oromia,West Shewa,Ambo Hospital,59,14,84,157
Teqemt,2nd,2010,Oromia,Jimma,Mancho,46,26,79,151
Teqemt,2nd,2011,Oromia,West Arsi,Arsi Negele Rural,61,54,9,124
Hamle,11th,2010,Oromia,Jimma,Shabe,62,2,56,120
Sene,10th,2009,Oromia,West Wellega,Haru,58,82,92,232
Megabit,7th,2011,Oromia,Bale,Meda Welabu,87,36,78,201
Ginbot,9th,2010,Oromia,North Shewa,Kuyu Hospital,57,48,36,141
Ginbot,9th,2010,Oromia,Borena,Dhas,89,75,74,238
Tir,5th,2011,Oromia,West Hararge,Meiso,13,94,10,117
Hedar,3rd,2011,Oromia,Assela Town,Assela Town,93,37,76,206
Meskerem,1st,2010,Oromia,East Shewa,Batu,30,13,28,71
Ginbot,9th,2009,Oromia,Finfine Zuria,Walmera,85,71,49,205
Hedar,3rd,2011,Oromia,East Wellega,Wama Hagelo,86,25,60,171
Tir,5th,2010,Oromia,Finfine Zuria,Mullo,64,15,73,152
Teqemt,2nd,2011,Oromia,Jimma,Mana,45,95,49,189
Yekatit,6th,2011,Oromia,Jimma,Mancho,70,37,43,150
Tir,5th,2011,Oromia,Jimma,Limu Kosa,32,98,22,152
Teqemt,2nd,2010,Oromia,Nekemte Town,Nekemte Town,94,7,68,169
Megabit,7th,2009,Oromia,East Hararge,Haromaya Town,52,83,11,146
Hamle,11th,2010,Oromia,Borena,Meyo,55,85,63,203
Nehase,12th,2010,Oromia,West Wellega,Gimbi Public  Hospital,84,47,47,178
Sene,10th,2011,Oromia,East Shewa,Bora,14,31,58,103
Miyazia,8th,2009,Oromia,West Shewa,Liban Jawi,98,48,54,200
Yekatit,6th,2010,Oromia,West Arsi,Gedeb Asasa,90,11,57,158
Hedar,3rd,2011,Oromia,Buno Bedele,Chewaqa,58,93,44,195
Hedar,3rd,2011,Oromia,Woliso Town,Woliso Town,65,41,69,175
Nehase,12th,2009,Oromia,Bale,Seweyna,6,28,85,119
Sene,10th,2011,Oromia,Arsi,Digeluna Tijo,7,16,72,95
Meskerem,1st,2010,Oromia,North Shewa,Fichetown,93,1,36,130
Ginbot,9th,2009,Oromia,Buno Bedele,Diga,7,45,50,102
Nehase,12th,2010,Oromia,North Shewa,Hidabu Abote,94,44,71,209
Teqemt,2nd,2010,Oromia,East Hararge,Deder,2,40,31,73
Teqemt,2nd,2010,Oromia,Ilu Aba Bora,Metu Rural,66,67,26,159
Sene,10th,2010,Oromia,Assela Town,Assela Town,95,64,91,250
Tahesas,4th,2010,Oromia,West Shewa,Ejersa Lafo,21,52,73,146
Megabit,7th,2009,Oromia,West Hararge,Chiro Hospital,34,67,86,187
Megabit,7th,2009,Oromia,East Wellega,Wayu Tuqa,85,28,30,143
Tir,5th,2009,Oromia,Shashamane Town,Shashamane Town,42,94,36,172
Hamle,11th,2009,Oromia,West Arsi,Adaba,25,98,14,137
Yekatit,6th,2009,Oromia,Horo Gudru Wellega,Hababo Guduru,11,27,35,73
Megabit,7th,2011,Oromia,South West Shewa,Ameya Hospital,97,10,89,196
Meskerem,1st,2011,Oromia,West Hararge,Habro,22,90,55,167
Miyazia,8th,2010,Oromia,West Hararge,Hawi Gudina,81,44,47,172
Hedar,3rd,2010,Oromia,West Shewa,Gindeberet Hospital,83,92,92,267
Megabit,7th,2010,Oromia,West Arsi,Arsi Negele Rural,35,11,65,111
Miyazia,8th,2009,Oromia,Jimma,Setema,45,99,32,176
Ginbot,9th,2011,Oromia,Adama Special Town,Adama Town,42,11,91,144
Yekatit,6th,2011,Oromia,East Hararge,Deder Town,56,38,6,100
Ginbot,9th,2011,Oromia,East Hararge,Kersa Eh,9,62,37,108
Sene,10th,2009,Oromia,Finfine Zuria,Holeta,5,62,44,111
Nehase,12th,2009,Oromia,Buno Bedele,Meko,16,60,9,85
Tir,5th,2009,Oromia,Horo Gudru Wellega,Jima Geneti,56,31,47,134
Ginbot,9th,2010,Oromia,West Shewa,Jeldu,76,72,33,181
Nehase,12th,2009,Oromia,Borena,Arero,20,5,40,65
Tir,5th,2009,Oromia,Horo Gudru Wellega,Hababo Guduru,22,23,25,70
Miyazia,8th,2011,Oromia,West Hararge,Burka Dimtu,29,27,35,91
Hedar,3rd,2010,Oromia,West Wellega,Nejo Rural,73,0,38,111
Megabit,7th,2009,Oromia,Qeleme Wellega,Hawa Gelan,62,77,34,173
Megabit,7th,2009,Oromia,Bale,Berbere,40,2,93,135
Megabit,7th,2011,Oromia,East Hararge,Jarso,89,31,13,133
Megabit,7th,2010,Oromia,North Shewa,Jido,62,9,92,163
Ginbot,9th,2011,Oromia,Jimma,Sekoru,40,61,1,102
Ginbot,9th,2011,Oromia,Qeleme Wellega,Hawa Gelan,52,96,97,245
Teqemt,2nd,2011,Oromia,Woliso Town,Woliso Town,18,36,53,107
Ginbot,9th,2010,Oromia,West Arsi,Dodola Town,74,59,73,206
Megabit,7th,2009,Oromia,East Shewa,Fentale,84,93,33,210
Nehase,12th,2010,Oromia,Guji,Anna Sora,18,80,64,162
Yekatit,6th,2011,Oromia,Jimma,Sekoru,16,36,92,144
Tir,5th,2010,Oromia,South West Shewa,Ameya,22,63,78,163
Ginbot,9th,2010,Oromia,West Wellega,Gimbi Adventist Hospital,66,72,65,203
Megabit,7th,2009,Oromia,Jimma,Shabe,13,98,69,180
Hedar,3rd,2011,Oromia,North Shewa,Debre Libanos,24,76,86,186
Tir,5th,2011,Oromia,Horo Gudru Wellega,Amuru,87,57,42,186
Ginbot,9th,2009,Oromia,Bale,Agarfa,27,38,28,93
Teqemt,2nd,2010,Oromia,West Wellega,Mene Sibu,39,85,50,174
Megabit,7th,2010,Oromia,Qeleme Wellega,Seyo,34,3,0,37
Tir,5th,2009,Oromia,Ilu Aba Bora,Becho,50,36,82,168
Hamle,11th,2009,Oromia,West Arsi,Gambo Hospital,65,74,17,156
Teqemt,2nd,2011,Oromia,West Hararge,Mesela,29,82,35,146
Hedar,3rd,2011,Oromia,Ilu Aba Bora,Halu,67,60,19,146
Miyazia,8th,2010,Oromia,West Shewa,Dano,36,76,5,117
Meskerem,1st,2010,Oromia,East Wellega,Limu,94,55,25,174
Ginbot,9th,2009,Oromia,South West Shewa,Dawo,17,97,45,159
Nehase,12th,2010,Oromia,West Arsi,Dodola  Hospital,65,68,48,181
Meskerem,1st,2011,Oromia,East Wellega,Sasiga,82,83,25,190
Hedar,3rd,2011,Oromia,Guji,Bore,37,63,72,172
Tahesas,4th,2011,Oromia,West Guji,Abaya,19,82,53,154
Sene,10th,2010,Oromia,Finfine Zuria,Sandefa,38,14,18,70
Hamle,11th,2009,Oromia,Arsi,Shenan Kolu,90,4,65,159
Tir,5th,2009,Oromia,Ilu Aba Bora,Halu,48,3,93,144
Hamle,11th,2010,Oromia,Qeleme Wellega,Dambi Dollo,81,70,93,244
Sene,10th,2011,Oromia,Arsi,Jeju,70,54,53,177
Yekatit,6th,2009,Oromia,Borena,Dire,80,79,20,179
Tir,5th,2010,Oromia,West Guji,Hanbala,8,10,65,83
Tir,5th,2010,Oromia,East Wellega,Boneya Bushe,4,30,2,36
Megabit,7th,2011,Oromia,Modjo Town,Modjo Town,51,89,16,156
Sene,10th,2010,Oromia,Arsi,Bekoji Town,60,86,19,165
Meskerem,1st,2010,Oromia,Ilu Aba Bora,Doreni,18,90,39,147
Hamle,11th,2009,Oromia,Assela Town,Assela Town,68,29,7,104
Teqemt,2nd,2010,Oromia,Buno Bedele,Meko,73,6,62,141
Hedar,3rd,2011,Oromia,Jimma,B/Tolyi,73,65,47,185
Tir,5th,2011,Oromia,East Wellega,Sasiga,71,37,47,155
Miyazia,8th,2010,Oromia,Buno Bedele,Chora,30,94,88,212
Sene,10th,2011,Oromia,East Hararge,Bedeno,22,19,5,46
Ginbot,9th,2011,Oromia,North Shewa,Jido,60,52,89,201
Miyazia,8th,2010,Oromia,Borena,Dhas,72,19,25,116
Ginbot,9th,2011,Oromia,Qeleme Wellega,Anfilo,22,56,34,112
Sene,10th,2009,Oromia,Buno Bedele,Meko,88,31,58,177
Tahesas,4th,2011,Oromia,Borena,Moyale Hospital,65,86,69,220
Nehase,12th,2010,Oromia,Borena,Dire,11,47,11,69
Nehase,12th,2010,Oromia,Finfine Zuria,Walmera,84,38,9,131
Yekatit,6th,2011,Oromia,Guji,Wadara,32,41,94,167
Meskerem,1st,2011,Oromia,Buno Bedele,Gechi,72,65,49,186
Tahesas,4th,2011,Oromia,West Hararge,Meiso,70,62,86,218
Hedar,3rd,2011,Oromia,Jimma,Limu Kosa,13,29,94,136
Hedar,3rd,2011,Oromia,Arsi,Bale Gesgara,54,78,69,201
Teqemt,2nd,2011,Oromia,Buno Bedele,Boricha,44,84,0,128
Hamle,11th,2009,Oromia,Bishoftu Town,Bishoftu Town,49,10,14,73
Tahesas,4th,2011,Oromia,West Shewa,Ilu Galan,85,94,37,216
Miyazia,8th,2009,Oromia,West Wellega,Nejo Hospital,51,96,61,208
Sene,10th,2011,Oromia,West Wellega,Boji Cheqorsa,98,66,41,205
Yekatit,6th,2009,Oromia,Adama Special Town,Adama Town,55,14,92,161
Hedar,3rd,2010,Oromia,Modjo Town,Modjo Town,41,34,66,141
Megabit,7th,2010,Oromia,East Wellega,Gobu Seyo,11,13,99,123
Tir,5th,2010,Oromia,West Hararge,Guba Qoricha,77,95,15,187
Hamle,11th,2010,Oromia,Assela Town,Assela Town,33,46,84,163
Hamle,11th,2010,Oromia,North Shewa,Kimbibit,83,20,98,201
Megabit,7th,2011,Oromia,Jimma,Omonada,51,25,91,167
Tir,5th,2011,Oromia,North Shewa,Dera Hospital,90,19,54,163
Ginbot,9th,2011,Oromia,South West Shewa,Dawo,44,32,75,151
Megabit,7th,2010,Oromia,West Arsi,Gambo Hospital,35,94,59,188
Miyazia,8th,2010,Oromia,Buno Bedele,Diga,81,73,17,171
Tir,5th,2011,Oromia,Arsi,Digeluna Tijo,14,71,36,121
Tir,5th,2011,Oromia,Jimma,Omo Nada Hospital,29,23,65,117
Hedar,3rd,2011,Oromia,East Shewa,Adama,59,47,77,183
Hamle,11th,2010,Oromia,West Guji,Kercha Hospital,80,69,73,222
Nehase,12th,2009,Oromia,Finfine Zuria,Holeta,40,41,9,90
Tir,5th,2010,Oromia,West Hararge,Gelemso Hospital,28,82,67,177
Tir,5th,2010,Oromia,Bale,Dinsho,61,17,12,90
Tir,5th,2010,Oromia,West Shewa,Gojo Hospital,90,30,30,150
Ginbot,9th,2011,Oromia,Guji,Bore,48,15,73,136
Megabit,7th,2009,Oromia,Finfine Zuria,Mullo,21,39,88,148
Sene,10th,2009,Oromia,West Arsi,Dodola Town,45,50,94,189
Tir,5th,2011,Oromia,West Hararge,Bedesa Town,47,80,87,214
Teqemt,2nd,2011,Oromia,West Hararge,Boke,9,34,88,131
Tir,5th,2009,Oromia,Jimma,Gera,78,25,43,146
Ginbot,9th,2011,Oromia,West Shewa,Nono,22,41,75,138
Megabit,7th,2010,Oromia,Finfine Zuria,Sebeta Awas,35,64,79,178
Nehase,12th,2009,Oromia,West Wellega,Mendi Town,58,70,67,195
Sene,10th,2011,Oromia,Arsi,Bale Gesgara,87,76,37,200
Miyazia,8th,2010,Oromia,West Arsi,Bishan Guracha Town,8,16,43,67
Yekatit,6th,2011,Oromia,Nekemte Town,Nekemte Town,75,16,31,122
Hedar,3rd,2010,Oromia,Buno Bedele,Dapho Hana,80,65,70,215
Hamle,11th,2010,Oromia,North Shewa,Kimbibit,39,43,88,170
Teqemt,2nd,2010,Oromia,Finfine Zuria,Mullo,74,39,32,145
Ginbot,9th,2011,Oromia,East Hararge,Meyu Muleke,89,2,56,147
Teqemt,2nd,2010,Oromia,West Wellega,Begi Hospital,76,99,11,186
Tir,5th,2009,Oromia,Qeleme Wellega,Gidami,32,96,32,160
Yekatit,6th,2010,Oromia,West Wellega,Homa,10,53,17,80
Tahesas,4th,2010,Oromia,West Shewa,Nono,22,1,62,85
Teqemt,2nd,2011,Oromia,Arsi,Robe,88,29,4,121
Hedar,3rd,2010,Oromia,South West Shewa,Tulu Bolo Hospital,22,90,95,207
Hedar,3rd,2010,Oromia,East Hararge,Deder Hospital,62,12,25,99
Nehase,12th,2010,Oromia,East Wellega,Guto Gida,24,80,9,113
Ginbot,9th,2011,Oromia,East Wellega,Gobu Seyo,92,71,53,216
Tir,5th,2011,Oromia,West Hararge,Guba Qoricha,7,76,48,131
Ginbot,9th,2010,Oromia,West Shewa,Nono,5,23,54,82
Miyazia,8th,2011,Oromia,Buno Bedele,Meko,52,75,1,128
Meskerem,1st,2010,Oromia,East Wellega,Boneya Bushe,9,46,10,65
Yekatit,6th,2010,Oromia,Guji,Adola Town,36,70,60,166
Ginbot,9th,2010,Oromia,Jimma,Mancho,65,35,28,128
Hedar,3rd,2011,Oromia,Bale,Agarfa,98,49,45,192
Nehase,12th,2010,Oromia,Assela Town,Assela Town,79,44,1,124
Yekatit,6th,2011,Oromia,West Hararge,Doba,23,33,74,130
Miyazia,8th,2010,Oromia,Shashamane Town,Shashamane Town,98,54,77,229
Nehase,12th,2009,Oromia,Buno Bedele,Boricha,50,40,69,159
Ginbot,9th,2011,Oromia,East Shewa,Boset,88,47,43,178
Ginbot,9th,2011,Oromia,Guji,Adola Reda,83,89,37,209
Ginbot,9th,2010,Oromia,West Shewa,Bako Tibe,23,23,84,130
Miyazia,8th,2009,Oromia,South West Shewa,Becho,90,17,35,142
Tahesas,4th,2010,Oromia,East Shewa,Adama,10,38,10,58
Tahesas,4th,2011,Oromia,Guji,Girja,67,99,4,170
Megabit,7th,2009,Oromia,East Wellega,Diga,24,72,63,159
Yekatit,6th,2010,Oromia,Qeleme Wellega,Dale Sedi,63,63,41,167
Teqemt,2nd,2010,Oromia,West Shewa,Gojo Hospital,42,13,98,153
Hamle,11th,2009,Oromia,East Shewa,Matahara,20,4,67,91
Yekatit,6th,2010,Oromia,West Wellega,Mendi Town,16,46,46,108
Nehase,12th,2010,Oromia,Shashamane Town,Shashamane Town,60,41,35,136
Hamle,11th,2009,Oromia,West Wellega,Gimbi Public  Hospital,42,79,9,130
Teqemt,2nd,2011,Oromia,Gelan Town,Gelan Town,71,92,53,216
Teqemt,2nd,2010,Oromia,West Hararge,Meiso,36,77,58,171
Hedar,3rd,2010,Oromia,South West Shewa,Seden Sodo,64,69,94,227
Hamle,11th,2010,Oromia,Arsi,Shenan Kolu,44,74,4,122
Miyazia,8th,2011,Oromia,Arsi,Zeway Dugda,51,15,87,153
Tahesas,4th,2011,Oromia,Jimma,Omo Nada Hospital,57,53,84,194
Megabit,7th,2011,Oromia,Lege Dadi Lege Tafo Town,Lege Dadi Lege Tafo Town,92,12,18,122
Teqemt,2nd,2011,Oromia,Guji,Liben,80,69,13,162
Miyazia,8th,2011,Oromia,East Wellega,Sasiga,38,61,48,147
Nehase,12th,2009,Oromia,East Wellega,Haro Limu,67,48,94,209
Yekatit,6th,2011,Oromia,North Shewa,Degem,63,22,13,98
Ginbot,9th,2010,Oromia,East Shewa,Fentale,1,98,15,114
Yekatit,6th,2011,Oromia,Ambo Town,Ambo Town,75,80,9,164
Hamle,11th,2010,Oromia,East Shewa,Gimbichu,33,32,1,66
Megabit,7th,2011,Oromia,Qeleme Wellega,Sedan Chanka,34,84,93,211
Yekatit,6th,2011,Oromia,West Guji,Bule Hora Toun,86,68,55,209
Tahesas,4th,2011,Oromia,South West Shewa,Ameya,96,65,3,164
Meskerem,1st,2010,Oromia,Guji,Adola Reda,44,22,51,117
Meskerem,1st,2010,Oromia,West Shewa,Jibat,60,42,45,147
Ginbot,9th,2011,Oromia,Bale,Gololcha,83,95,46,224
Nehase,12th,2009,Oromia,Arsi,Enkelo Wabe,87,19,96,202
Sene,10th,2011,Oromia,Nekemte Town,Nekemte Town,43,58,34,135
Hedar,3rd,2011,Oromia,East Hararge,Deder,80,26,59,165
Tir,5th,2009,Oromia,North Shewa,Yaya Gulele,75,44,15,134
Meskerem,1st,2010,Oromia,West Arsi,Shashemene Rural,41,24,80,145
Sene,10th,2011,Oromia,West Guji,Biebirsa Kojowa,55,44,71,170
Hamle,11th,2009,Oromia,North Shewa,Girar Jarso,92,34,8,134
Nehase,12th,2010,Oromia,West Arsi,Loke Hada Hospital,65,48,12,125
Sene,10th,2010,Oromia,West Arsi,Hebal Arsi,0,59,55,114
Nehase,12th,2009,Oromia,North Shewa,Fichetown,36,76,66,178
Ginbot,9th,2011,Oromia,Qeleme Wellega,Sedan Chanka,67,67,51,185
Sene,10th,2009,Oromia,West Guji,Dugda Dawa,4,70,86,160
Tir,5th,2011,Oromia,Buno Bedele,Chora,20,3,1,24
Sene,10th,2009,Oromia,Sululta Town,Sululta Town,0,25,59,84
Nehase,12th,2009,Oromia,East Shewa,Batu,48,9,42,99
Meskerem,1st,2010,Oromia,Borena,Dilo,54,36,76,166
Hamle,11th,2010,Oromia,West Arsi,Dodola  Hospital,22,12,44,78
Hamle,11th,2010,Oromia,East Hararge,Fedis,17,15,73,105
Miyazia,8th,2010,Oromia,West Wellega,Gimbi Adventist Hospital,17,2,11,30
Tir,5th,2011,Oromia,East Hararge,Goro Muti,29,88,58,175
Nehase,12th,2009,Oromia,East Hararge,Babile Woreda,38,0,47,85
Hedar,3rd,2010,Oromia,West Wellega,Boji Cheqorsa,84,41,11,136
Tir,5th,2009,Oromia,Buno Bedele,Diga,58,90,39,187
Hedar,3rd,2011,Oromia,Jimma,Sigmo,9,43,13,65
Tahesas,4th,2010,Oromia,East Shewa,Matahara,56,62,99,217
Hedar,3rd,2011,Oromia,West Wellega,Gimbi Public  Hospital,72,27,92,191
Megabit,7th,2009,Oromia,North Shewa,Fichetown,17,14,24,55
Hamle,11th,2010,Oromia,West Guji,Mkelka Soda,12,24,5,41
Sene,10th,2010,Oromia,Ilu Aba Bora,Ale,61,31,86,178
Megabit,7th,2011,Oromia,Arsi,Shirka,45,43,44,132
Miyazia,8th,2010,Oromia,West Hararge,Tulo,77,56,85,218
Megabit,7th,2010,Oromia,West Wellega,Mendi Hospital,87,98,82,267
Tahesas,4th,2011,Oromia,West Shewa,Bako Tibe,61,91,73,225
Tahesas,4th,2010,Oromia,West Hararge,Habro,28,47,1,76
Hamle,11th,2010,Oromia,West Shewa,Bako Tibe,97,55,17,169
Megabit,7th,2009,Oromia,Buno Bedele,Chora,94,99,58,251
Sene,10th,2009,Oromia,Guji,Adola Town,43,87,91,221
Miyazia,8th,2009,Oromia,West Shewa,Bako Tibe,57,72,23,152
Teqemt,2nd,2010,Oromia,South West Shewa,Tulu Bolo Hospital,31,18,73,122
Tahesas,4th,2011,Oromia,Finfine Zuria,Sandefa,45,90,40,175
Teqemt,2nd,2011,Oromia,Ilu Aba Bora,Doreni,31,27,82,140
Miyazia,8th,2009,Oromia,Lege Dadi Lege Tafo Town,Lege Dadi Lege Tafo Town,68,71,2,141
Miyazia,8th,2010,Oromia,Jimma,Limu Seka,40,69,89,198
Yekatit,6th,2009,Oromia,Jimma,Mana,32,12,97,141
Teqemt,2nd,2010,Oromia,West Shewa,Jibat,71,57,27,155
Tir,5th,2011,Oromia,West Arsi,Siraro,14,34,20,68
Teqemt,2nd,2011,Oromia,West Wellega,Boji Cheqorsa,28,72,43,143
Nehase,12th,2010,Oromia,Horo Gudru Wellega,Shambu Hospital,3,50,24,77
Megabit,7th,2010,Oromia,Arsi,Seru,27,63,52,142
Tir,5th,2011,Oromia,South West Shewa,Becho,73,18,98,189
Megabit,7th,2011,Oromia,West Guji,Suro Barguda,43,93,36,172
Ginbot,9th,2011,Oromia,Jimma,Mancho,44,16,17,77
Meskerem,1st,2011,Oromia,West Wellega,Mendi Hospital,12,29,13,54
Hamle,11th,2010,Oromia,West Wellega,Genji,22,35,63,120
Nehase,12th,2009,Oromia,West Wellega,Boji Cheqorsa,28,71,14,113
Sene,10th,2009,Oromia,Borena,Guchi,91,19,80,190
Hedar,3rd,2010,Oromia,East Hararge,Melka Belo,87,91,12,190
Hedar,3rd,2011,Oromia,Horo Gudru Wellega,Jima Rare,64,68,47,179
Tir,5th,2010,Oromia,Jimma,Gomma,25,73,22,120
Ginbot,9th,2010,Oromia,West Guji,Mkelka Soda,76,79,91,246
Hamle,11th,2009,Oromia,Arsi,Dodota,58,21,55,134
Megabit,7th,2010,Oromia,Jimma Spe Town,Jimma Spe Town,90,75,0,165
Miyazia,8th,2011,Oromia,Bale,Gololcha,99,76,60,235
Ginbot,9th,2011,Oromia,East Shewa,Boset,35,13,64,112
Meskerem,1st,2010,Oromia,West Shewa,Gojo Hospital,56,12,35,103
Hamle,11th,2009,Oromia,West Arsi,Wondo,36,50,99,185
Meskerem,1st,2011,Oromia,West Hararge,Doba,40,83,51,174
Nehase,12th,2010,Oromia,Finfine Zuria,Berreh,32,22,89,143
Sene,10th,2009,Oromia,Arsi,Enkelo Wabe,66,32,77,175
Hamle,11th,2010,Oromia,Robe Town,Robe Town,35,85,27,147
Yekatit,6th,2009,Oromia,Bale,Arena Buluq,83,35,16,134
Yekatit,6th,2011,Oromia,Shashamane Town,Shashamane Town,15,44,20,79
Yekatit,6th,2009,Oromia,East Hararge,Meta,10,5,53,68
Tir,5th,2010,Oromia,Qeleme Wellega,Yemalogi Wolel,77,91,88,256
Tahesas,4th,2010,Oromia,West Guji,Bule Hora,98,64,33,195
Yekatit,6th,2010,Oromia,Borena,Dhas,23,42,63,128
Miyazia,8th,2011,Oromia,Guji,Anna Sora,31,8,74,113
Megabit,7th,2011,Oromia,Qeleme Wellega,Sedan Chanka,13,59,94,166
Tahesas,4th,2011,Oromia,Ilu Aba Bora,Yayu,72,36,95,203
Nehase,12th,2010,Oromia,Arsi,Deksis,70,76,12,158
Nehase,12th,2009,Oromia,Arsi,Tena,1,14,95,110
Megabit,7th,2010,Oromia,West Hararge,Anchar,31,39,71,141
Megabit,7th,2009,Oromia,Bale,Meda Welabu,87,28,29,144
Megabit,7th,2009,Oromia,East Shewa,Lomme,34,33,40,107
Hedar,3rd,2011,Oromia,West Guji,Mkelka Soda,63,30,41,134
Miyazia,8th,2011,Oromia,Guji,Uraga,98,23,0,121
Miyazia,8th,2009,Oromia,Bale,Dawe Qachen,23,99,21,143
Tir,5th,2011,Oromia,South West Shewa,St.Luke Hospital,54,9,86,149
Hamle,11th,2010,Oromia,Arsi,Sire,90,6,71,167
Sene,10th,2009,Oromia,Borena,El Way,92,19,35,146
Megabit,7th,2009,Oromia,Bale,Goba Town,89,84,19,192
Teqemt,2nd,2010,Oromia,South West Shewa,Seden Sodo,59,18,43,120
Hamle,11th,2010,Oromia,Jimma,Agaro Hospital,19,63,88,170
Ginbot,9th,2009,Oromia,Jimma,Gomma,34,25,42,101
Hedar,3rd,2011,Oromia,Jimma,Dedo,17,74,28,119
Tahesas,4th,2011,Oromia,Bale,Meda Welabu,32,40,53,125
Sene,10th,2010,Oromia,West Shewa,Tibe Kutaye,98,99,40,237
Meskerem,1st,2010,Oromia,West Shewa,Ambo Hospital,73,85,17,175
Meskerem,1st,2010,Oromia,West Hararge,Hawi Gudina,3,68,98,169
Miyazia,8th,2009,Oromia,Ilu Aba Bora,Algesachi,97,56,27,180
Nehase,12th,2010,Oromia,West Hararge,Burka Dimtu,59,42,79,180
Hamle,11th,2009,Oromia,West Arsi,Kore,70,64,43,177
Megabit,7th,2009,Oromia,South West Shewa,Tole,7,74,16,97
Ginbot,9th,2011,Oromia,Finfine Zuria,Mullo,50,11,33,94
Nehase,12th,2009,Oromia,West Arsi,Dodola Rural,40,42,82,164
Sene,10th,2011,Oromia,Finfine Zuria,Sebeta Awas,54,24,22,100
Tahesas,4th,2010,Oromia,Bale,Gasera,40,3,96,139
Tahesas,4th,2011,Oromia,Jimma,Gomma,50,46,26,122
Tahesas,4th,2011,Oromia,West Wellega,Lalo Asabi,65,13,11,89
Yekatit,6th,2010,Oromia,East Hararge,Deder,11,81,19,111
Ginbot,9th,2009,Oromia,Gelan Town,Gelan Town,67,39,20,126
Megabit,7th,2009,Oromia,East Hararge,Meyu Muleke,9,60,51,120
Yekatit,6th,2010,Oromia,West Hararge,Bedesa Town,78,90,72,240
Ginbot,9th,2009,Oromia,West Hararge,Daro Lebu,28,71,87,186
Sene,10th,2011,Oromia,South West Shewa,Sodo Dac'Ha,7,31,18,56
Meskerem,1st,2011,Oromia,East Hararge,Midega Tole,81,56,38,175
Teqemt,2nd,2010,Oromia,North Shewa,Jido,41,43,41,125
Tir,5th,2011,Oromia,Bale,Gololcha,57,11,59,127
Tir,5th,2011,Oromia,Arsi,Limuna Bilbilo,94,33,32,159
Tir,5th,2011,Oromia,East Hararge,Bisidimo Hospital,74,19,26,119
Miyazia,8th,2009,Oromia,West Hararge,Chiro Hospital,42,96,45,183
Megabit,7th,2010,Oromia,West Arsi,Wondo,47,43,69,159
Teqemt,2nd,2011,Oromia,Arsi,Bekoji Town,36,49,69,154
Ginbot,9th,2009,Oromia,Borena,Moyale Hospital,49,3,36,88
Miyazia,8th,2009,Oromia,East Wellega,Ebantu,17,29,7,53
Hedar,3rd,2010,Oromia,Qeleme Wellega,Dambi Dollo,21,62,45,128
Sene,10th,2009,Oromia,West Hararge,Habro,45,37,9,91
Megabit,7th,2009,Oromia,West Hararge,Mesela,70,29,66,165
Tahesas,4th,2010,Oromia,West Wellega,Yubdo,49,38,30,117
Megabit,7th,2009,Oromia,West Shewa,Meta Waliqite,92,97,56,245
Megabit,7th,2010,Oromia,West Wellega,Kundala,71,55,79,205
Megabit,7th,2010,Oromia,South West Shewa,Tole,43,71,61,175
Sene,10th,2010,Oromia,West Hararge,Meiso,55,28,93,176
Nehase,12th,2010,Oromia,Bale,Raitu,57,57,66,180
Sene,10th,2011,Oromia,Arsi,Sude,3,95,50,148
Tahesas,4th,2010,Oromia,North Shewa,Dera,93,55,94,242
Nehase,12th,2010,Oromia,Qeleme Wellega,Gidami,39,96,43,178
Sene,10th,2009,Oromia,Horo Gudru Wellega,Amuru,19,98,23,140
Hedar,3rd,2010,Oromia,Qeleme Wellega,Hawa Gelan,53,35,7,95
Miyazia,8th,2011,Oromia,Horo Gudru Wellega,Horro Buluk,41,26,38,105
Ginbot,9th,2009,Oromia,East Shewa,Fentale,26,25,45,96
Nehase,12th,2010,Oromia,West Guji,Kercha,41,85,8,134
Miyazia,8th,2011,Oromia,Arsi,Sire,22,6,68,96
Hedar,3rd,2011,Oromia,West Guji,Mkelka Soda,47,0,32,79
Sene,10th,2011,Oromia,Qeleme Wellega,Sedan Chanka,91,20,73,184
Megabit,7th,2010,Oromia,West Guji,Kercha Hospital,72,8,83,163
Hedar,3rd,2011,Oromia,Borena,Teltele,58,85,49,192
Hedar,3rd,2010,Oromia,Jimma,Omonada,45,75,83,203
Megabit,7th,2009,Oromia,South West Shewa,Kersana Malima,6,56,1,63
Hamle,11th,2010,Oromia,West Wellega,Yubdo,99,86,62,247
Tir,5th,2010,Oromia,West Shewa,Codi,71,58,45,174
Teqemt,2nd,2010,Oromia,West Shewa,Dendi,93,38,13,144
Tir,5th,2010,Oromia,Horo Gudru Wellega,Jima Rare,7,24,58,89
Yekatit,6th,2011,Oromia,Arsi,Bekoji Town,9,97,30,136
Sene,10th,2011,Oromia,South West Shewa,Ilu,60,70,36,166
Megabit,7th,2011,Oromia,West Wellega,Nejo Hospital,51,34,15,100
Megabit,7th,2009,Oromia,West Guji,Dugda Dawa,6,87,1,94
Tahesas,4th,2010,Oromia,Qeleme Wellega,Gawo Qebe,55,62,89,206
Hamle,11th,2009,Oromia,North Shewa,Fiche Hospital,37,46,44,127
Tir,5th,2011,Oromia,North Shewa,Dera Hospital,76,96,49,221
Hedar,3rd,2010,Oromia,Guji,Uraga,22,48,23,93
Tahesas,4th,2011,Oromia,East Hararge,Kurfa Chele,47,38,18,103
Tir,5th,2011,Oromia,Bale,Ginir,54,71,50,175
Tir,5th,2010,Oromia,West Wellega,Seyo Nole,55,91,19,165
Meskerem,1st,2010,Oromia,West Hararge,Chiro Town,90,82,22,194
Miyazia,8th,2011,Oromia,East Wellega,Nunu Qumba,87,9,52,148
Yekatit,6th,2010,Oromia,West Guji,Kercha Hospital,70,80,86,236
Yekatit,6th,2009,Oromia,Horo Gudru Wellega,Shambu Town,66,20,25,111
Tir,5th,2011,Oromia,Bale,Seweyna,48,70,28,146
Ginbot,9th,2010,Oromia,West Hararge,West Harerge	Gumbi Bordede,34,12,84,130
Megabit,7th,2009,Oromia,West Guji,Kercha,70,92,21,183
Megabit,7th,2009,Oromia,Finfine Zuria,Akaki,42,77,71,190
Tir,5th,2011,Oromia,Jimma,O/Beyam,39,8,40,87
Hamle,11th,2009,Oromia,East Hararge,Melka Belo,48,41,39,128
Nehase,12th,2010,Oromia,South West Shewa,Wonchi,69,23,64,156
Hedar,3rd,2011,Oromia,Bale,Arena Buluq,45,67,31,143
Hedar,3rd,2011,Oromia,Qeleme Wellega,Yemalogi Wolel,5,81,14,100
Hedar,3rd,2010,Oromia,Borena,Dubluk,25,66,34,125
Tir,5th,2009,Oromia,Horo Gudru Wellega,Horo,61,18,80,159
Tahesas,4th,2011,Oromia,South West Shewa,Ameya,55,93,72,220
Tir,5th,2009,Oromia,East Wellega,Ebantu,1,65,84,150
Tir,5th,2011,Oromia,West Arsi,Dodola  Hospital,53,47,6,106
Ginbot,9th,2011,Oromia,South West Shewa,St.Luke Hospital,59,8,53,120
Yekatit,6th,2009,Oromia,East Hararge,Chelenko Hospital,12,67,94,173
Tir,5th,2011,Oromia,West Hararge,Chiro Town,35,20,94,149
Nehase,12th,2010,Oromia,Ilu Aba Bora,Nono Sele,60,22,38,120
Yekatit,6th,2010,Oromia,North Shewa,Hidabu Abote,17,56,82,155
Ginbot,9th,2010,Oromia,East Wellega,Gobu Seyo,85,51,84,220
Megabit,7th,2010,Oromia,Guji,Uraga,18,64,22,104
Tir,5th,2011,Oromia,North Shewa,Fiche Hospital,93,49,47,189
Teqemt,2nd,2011,Oromia,Arsi,Bekoji Town,98,45,38,181
Teqemt,2nd,2010,Oromia,East Hararge,Deder,24,42,47,113
Megabit,7th,2011,Oromia,West Arsi,Shala,68,8,12,88
Nehase,12th,2010,Oromia,West Shewa,Jibat,57,17,90,164
Yekatit,6th,2009,Oromia,West Wellega,Nole Kaba,41,22,66,129
Tahesas,4th,2011,Oromia,West Wellega,Boji Dermeji,44,11,41,96
Sene,10th,2011,Oromia,East Shewa,Dugda,98,60,26,184
Hamle,11th,2009,Oromia,West Shewa,Chelia,68,41,82,191
Sene,10th,2009,Oromia,West Arsi,Adaba,1,85,35,121
Megabit,7th,2011,Oromia,Finfine Zuria,Sululta Town,3,38,63,104
Ginbot,9th,2010,Oromia,Ilu Aba Bora,Bilonopa,5,71,28,104
Megabit,7th,2011,Oromia,Borena,Yabelo Rural,28,7,45,80
Yekatit,6th,2011,Oromia,West Wellega,Boji Dermeji,90,30,41,161
Miyazia,8th,2010,Oromia,Jimma,Limu Kosa,9,87,71,167
Sene,10th,2011,Oromia,West Arsi,Dodola  Hospital,48,93,27,168
Miyazia,8th,2009,Oromia,East Hararge,Meyu Muleke,19,65,72,156
Nehase,12th,2009,Oromia,Guji,Liben,33,85,80,198
Nehase,12th,2009,Oromia,West Guji,Bule Hora Toun,5,38,15,58
Ginbot,9th,2009,Oromia,East Shewa,Liben,56,57,61,174
Meskerem,1st,2011,Oromia,Borena,Dilo,79,92,81,252
Ginbot,9th,2011,Oromia,West Shewa,Bako Hospital,93,25,93,211
Megabit,7th,2009,Oromia,Arsi,Amigna,33,35,87,155
Sene,10th,2011,Oromia,Holeta Town,Holeta Town,49,32,53,134
Nehase,12th,2009,Oromia,West Shewa,Ginde Beret,69,6,51,126
Miyazia,8th,2011,Oromia,Finfine Zuria,Sululta Town,26,96,36,158
Sene,10th,2010,Oromia,East Hararge,Haromaya Rural,73,20,75,168
Hedar,3rd,2011,Oromia,East Hararge,Meyu Muleke,6,89,13,108
Sene,10th,2009,Oromia,Jimma,Seka Chekorsa,24,13,72,109
Nehase,12th,2010,Oromia,Guji,Goro Dola,64,14,70,148
Tir,5th,2010,Oromia,Horo Gudru Wellega,Amuru,43,57,14,114
Megabit,7th,2009,Oromia,Sululta Town,Sululta Town,68,0,54,122
Miyazia,8th,2009,Oromia,East Wellega,Sasiga,84,79,87,250
Tahesas,4th,2011,Oromia,Guji,Dima,18,13,10,41
Ginbot,9th,2009,Oromia,Jimma,Chora Boter,27,36,43,106
Sene,10th,2010,Oromia,West Arsi,Dodola Rural,54,67,86,207
Teqemt,2nd,2011,Oromia,Borena,Guchi,62,19,85,166
Miyazia,8th,2009,Oromia,West Shewa,Liban Jawi,55,91,94,240
Ginbot,9th,2011,Oromia,Guji,Aga Wayyu,22,63,9,94
Megabit,7th,2009,Oromia,West Arsi,Nensebo,35,36,37,108
Hedar,3rd,2010,Oromia,West Wellega,Lalo Asabi,73,19,21,113
Hedar,3rd,2010,Oromia,North Shewa,Yaya Gulele,9,7,75,91
Sene,10th,2010,Oromia,Borena,Yabelo Rural,80,23,97,200
Hedar,3rd,2011,Oromia,Jimma,Limu Seka,54,28,34,116
Meskerem,1st,2011,Oromia,Jimma,Setema,91,21,17,129
Ginbot,9th,2010,Oromia,West Arsi,Arsi Negele Town,50,29,10,89
Megabit,7th,2011,Oromia,Jimma,Seka Chekorsa,76,55,0,131
Nehase,12th,2010,Oromia,West Hararge,Chiro Town,21,17,22,60
Teqemt,2nd,2011,Oromia,West Shewa,Bako Tibe,81,35,89,205
Sene,10th,2010,Oromia,West Arsi,Adaba,78,90,89,257
Tahesas,4th,2010,Oromia,West Hararge,Boke,95,99,96,290
Ginbot,9th,2010,Oromia,Finfine Zuria,Walmera,78,25,37,140
Teqemt,2nd,2010,Oromia,West Arsi,Arsi Negele Town,41,8,73,122
Yekatit,6th,2010,Oromia,East Wellega,Gida Ayana,22,91,91,204
Nehase,12th,2009,Oromia,East Hararge,Melka Belo,12,83,78,173
Yekatit,6th,2010,Oromia,Jimma,Sigmo,36,7,67,110
Tir,5th,2009,Oromia,Finfine Zuria,Holeta,22,61,13,96
Tahesas,4th,2010,Oromia,West Hararge,Chiro Zuriya,22,3,34,59
Sene,10th,2010,Oromia,East Hararge,Midega Tole,42,24,63,129
Tahesas,4th,2010,Oromia,Guji,Bore,37,94,34,165
Teqemt,2nd,2010,Oromia,North Shewa,Dera Hospital,77,64,11,152
Tahesas,4th,2011,Oromia,West Guji,Bule Hora Toun,39,1,4,44
Hedar,3rd,2011,Oromia,Borena,Moyale,41,83,4,128
Yekatit,6th,2010,Oromia,Woliso Town,Woliso Town,15,20,61,96
Yekatit,6th,2009,Oromia,West Wellega,Boji Dermeji,34,10,11,55
Teqemt,2nd,2010,Oromia,West Wellega,Boji Cheqorsa,4,72,83,159
Miyazia,8th,2009,Oromia,West Hararge,Oda Bultum,94,85,3,182
Miyazia,8th,2011,Oromia,Holeta Town,Holeta Town,73,86,7,166
Tir,5th,2009,Oromia,West Hararge,Chiro Town,73,70,2,145
Ginbot,9th,2009,Oromia,West Wellega,Mene Sibu,8,69,92,169
Miyazia,8th,2009,Oromia,West Shewa,Adea Berga,43,34,39,116
Hamle,11th,2009,Oromia,East Hararge,Kurfa Chele,12,64,82,158
Tir,5th,2011,Oromia,West Wellega,Yubdo,62,72,52,186
Ginbot,9th,2010,Oromia,Arsi,Hitosa,12,84,66,162
Hamle,11th,2010,Oromia,West Wellega,Nejo Hospital,84,9,70,163
Sene,10th,2011,Oromia,Buno Bedele,Bedele Zuriya,55,70,48,173
Tahesas,4th,2010,Oromia,Guji,Uraga,56,75,26,157
Tahesas,4th,2011,Oromia,Arsi,Bekoji Town,91,91,72,254
Tahesas,4th,2011,Oromia,West Hararge,Chiro Town,60,5,14,79
Miyazia,8th,2011,Oromia,Guji,Dima,97,42,70,209
Tir,5th,2010,Oromia,East Hararge,Deder Town,33,61,79,173
Miyazia,8th,2010,Oromia,West Hararge,Mesela,28,22,67,117
Ginbot,9th,2009,Oromia,North Shewa,Fichetown,66,83,24,173
Yekatit,6th,2011,Oromia,West Wellega,Genji,13,25,1,39
Hamle,11th,2010,Oromia,Bale,Gololcha,42,82,10,134
Hamle,11th,2009,Oromia,West Wellega,Boji Dermeji,52,59,32,143
Megabit,7th,2011,Oromia,East Hararge,Fedis,25,93,69,187
Ginbot,9th,2011,Oromia,West Shewa,Jeldu,67,90,21,178
Sene,10th,2009,Oromia,North Shewa,Degem,27,10,4,41
Megabit,7th,2010,Oromia,Arsi,Limuna Bilbilo,29,22,42,93
Sene,10th,2009,Oromia,West Shewa,Bako Tibe,43,30,24,97
Hedar,3rd,2011,Oromia,West Wellega,Haru,63,81,21,165
Hedar,3rd,2011,Oromia,West Hararge,Burka Dimtu,76,26,8,110
Nehase,12th,2009,Oromia,Arsi,Munesa,20,11,68,99
Megabit,7th,2009,Oromia,North Shewa,Kuyu,6,74,28,108
Sene,10th,2010,Oromia,Bale,Dawe Qachen,36,64,26,126
Miyazia,8th,2011,Oromia,West Wellega,Gimbi Rural,44,76,28,148
Ginbot,9th,2009,Oromia,East Hararge,Deder Town,54,31,75,160
Hamle,11th,2010,Oromia,East Hararge,Haromaya Town,87,69,40,196
Miyazia,8th,2009,Oromia,Buno Bedele,Chora,11,94,26,131
Megabit,7th,2009,Oromia,Horo Gudru Wellega,Jarte Jardga,64,91,9,164
Tahesas,4th,2011,Oromia,Arsi,Gololcha,35,23,12,70
Hamle,11th,2009,Oromia,Horo Gudru Wellega,Jima Geneti,39,13,97,149
Megabit,7th,2010,Oromia,Horo Gudru Wellega,Shambu Town,38,89,79,206
Hedar,3rd,2011,Oromia,West Hararge,Guba Qoricha,8,5,78,91
Ginbot,9th,2010,Oromia,Borena,Yabelo Rural,24,16,45,85
Miyazia,8th,2009,Oromia,Arsi,Shirka,76,91,16,183
Meskerem,1st,2011,Oromia,Dukem Town,Dukem Town,7,97,97,201
Megabit,7th,2010,Oromia,Arsi,Aseko,83,66,23,172
Hedar,3rd,2010,Oromia,Borena,Moyale,30,4,30,64
Megabit,7th,2009,Oromia,East Hararge,Haromaya Hospital,0,83,22,105
Tir,5th,2009,Oromia,North Shewa,Wuchale,32,25,37,94
Teqemt,2nd,2011,Oromia,West Arsi,Gedeb Asasa,38,47,67,152
Nehase,12th,2009,Oromia,Arsi,Sire,30,30,68,128
Tahesas,4th,2010,Oromia,West Shewa,Ejerie,86,19,87,192
Meskerem,1st,2011,Oromia,Adama Special Town,Adama Town,5,65,45,115
Yekatit,6th,2010,Oromia,Guji,Shakiso Town,28,78,0,106
Tir,5th,2011,Oromia,Bale,Dawe Qachen,62,49,63,174
Megabit,7th,2010,Oromia,West Hararge,Tulo,89,37,4,130
Teqemt,2nd,2010,Oromia,Arsi,Digeluna Tijo,16,88,69,173
Nehase,12th,2010,Oromia,Horo Gudru Wellega,Horo,37,79,70,186
Teqemt,2nd,2010,Oromia,Bale,Ginir,88,93,86,267
Nehase,12th,2009,Oromia,West Arsi,Arsi Negele Town,43,44,84,171
Hamle,11th,2010,Oromia,South West Shewa,Tole,2,29,94,125
Ginbot,9th,2010,Oromia,Arsi,Hitosa,9,36,23,68
Megabit,7th,2010,Oromia,North Shewa,Fiche Hospital,7,49,89,145
Ginbot,9th,2009,Oromia,Ilu Aba Bora,Doreni,76,31,1,108
Meskerem,1st,2010,Oromia,West Hararge,Boke,6,32,83,121
Ginbot,9th,2010,Oromia,Borena,Arero,90,76,49,215
Meskerem,1st,2011,Oromia,Bale,Dawe Qachen,21,31,52,104
Nehase,12th,2009,Oromia,Arsi,Gololcha,51,28,66,145
Hamle,11th,2010,Oromia,North Shewa,Dera Hospital,65,2,31,98
Ginbot,9th,2011,Oromia,Arsi,Digeluna Tijo,32,77,54,163
Yekatit,6th,2010,Oromia,Finfine Zuria,Sululta Town,87,42,4,133
Tahesas,4th,2011,Oromia,Arsi,Sire,44,76,5,125
Tir,5th,2011,Oromia,West Wellega,Seyo Nole,63,83,72,218
Hamle,11th,2009,Oromia,Guji,Uraga,73,35,20,128
Miyazia,8th,2010,Oromia,West Arsi,Dodola  Hospital,87,13,12,112
Ginbot,9th,2011,Oromia,West Arsi,Dodola Town,56,46,54,156
Ginbot,9th,2009,Oromia,Qeleme Wellega,Anfilo,22,33,18,73
Hedar,3rd,2010,Oromia,Arsi,Gololcha,81,64,11,156
Meskerem,1st,2011,Oromia,North Shewa,Dera,48,84,95,227
Hamle,11th,2010,Oromia,Arsi,Zeway Dugda,45,89,32,166
Megabit,7th,2011,Oromia,West Wellega,Nole Kaba,84,17,49,150
Yekatit,6th,2010,Oromia,North Shewa,Abichugna,91,34,80,205
Hedar,3rd,2011,Oromia,Guji,Adola Town,8,81,15,104
Meskerem,1st,2010,Oromia,West Wellega,Begi,68,47,7,122
Hamle,11th,2009,Oromia,Ilu Aba Bora,Metu Town,34,28,80,142
Teqemt,2nd,2011,Oromia,Horo Gudru Wellega,Horro Buluk,51,79,3,133
Megabit,7th,2009,Oromia,East Wellega,Boneya Bushe,43,44,29,116
Megabit,7th,2009,Oromia,West Shewa,Ambo Hospital,57,34,77,168
Sene,10th,2009,Oromia,West Wellega,Haru,42,6,48,96
Tir,5th,2009,Oromia,Arsi,Bekoji Town,15,72,44,131
Ginbot,9th,2010,Oromia,Jimma,Guma,24,47,28,99
Nehase,12th,2010,Oromia,Borena,Yabelo,16,30,31,77
Tir,5th,2010,Oromia,Arsi,Guna,53,80,66,199
Sene,10th,2009,Oromia,Jimma,Dedo,57,4,39,100
Meskerem,1st,2010,Oromia,Bale,Gololcha,16,24,17,57
Nehase,12th,2009,Oromia,Borena,Dilo,25,98,35,158
Sene,10th,2011,Oromia,West Shewa,Gindeberet Hospital,91,44,12,147
Sene,10th,2011,Oromia,West Arsi,Dodola Rural,80,65,49,194
Nehase,12th,2010,Oromia,Horo Gudru Wellega,Hababo Guduru,16,85,37,138
Miyazia,8th,2011,Oromia,Gelan Town,Gelan Town,3,15,37,55
Ginbot,9th,2009,Oromia,East Hararge,Deder Hospital,15,25,63,103
Tir,5th,2010,Oromia,Arsi,Sire,31,68,40,139
Hedar,3rd,2011,Oromia,South West Shewa,Goro,24,93,24,141
Tir,5th,2009,Oromia,Arsi,Deksis,34,20,80,134
Ginbot,9th,2010,Oromia,Guji,Saba Boru,53,70,52,175
Yekatit,6th,2009,Oromia,West Wellega,Babo Gembel,27,85,98,210
Yekatit,6th,2009,Oromia,South West Shewa,Wonchi,55,10,92,157
Meskerem,1st,2010,Oromia,West Shewa,Tikur Enchini,89,26,67,182
Tir,5th,2011,Oromia,North Shewa,Debre Libanos,51,48,59,158
Tir,5th,2009,Oromia,Finfine Zuria,Sululta Town,92,6,5,103
Sene,10th,2010,Oromia,West Shewa,Tikur Enchini,30,67,64,161
Ginbot,9th,2011,Oromia,East Hararge,Kumbi,44,7,31,82
Sene,10th,2011,Oromia,East Hararge,Haromaya Rural,12,41,99,152
Tahesas,4th,2010,Oromia,West Wellega,Gimbi Adventist Hospital,69,64,23,156
Teqemt,2nd,2011,Oromia,East Shewa,Adea,33,92,78,203
Yekatit,6th,2011,Oromia,West Wellega,Guliso,58,75,31,164
Tir,5th,2011,Oromia,West Shewa,Ejerie,54,5,37,96
Miyazia,8th,2010,Oromia,Jimma,Nono Benja,44,99,42,185
Megabit,7th,2009,Oromia,Guji,Saba Boru,63,6,22,91
Yekatit,6th,2009,Oromia,East Shewa,Olanciti Hospital,89,49,44,182
Ginbot,9th,2010,Oromia,Ilu Aba Bora,Yayu,75,50,15,140
Hamle,11th,2010,Oromia,Horo Gudru Wellega,Shambu Town,68,36,33,137
Hamle,11th,2009,Oromia,Guji,Girja,95,2,40,137
Tir,5th,2010,Oromia,West Shewa,Tibe Kutaye,73,14,76,163
Yekatit,6th,2010,Oromia,Qeleme Wellega,Hawa Gelan,70,57,63,190
Megabit,7th,2011,Oromia,West Wellega,Kundala,61,30,60,151
Tir,5th,2011,Oromia,East Wellega,Kiremu,57,80,76,213
Sene,10th,2009,Oromia,Bale,Dawe Qachen,56,12,95,163
Ginbot,9th,2011,Oromia,West Wellega,Jarso,53,12,0,65
Megabit,7th,2009,Oromia,West Guji,Gelana,63,22,58,143
Nehase,12th,2010,Oromia,Buno Bedele,Bedele Hospital,22,2,9,33
Tahesas,4th,2011,Oromia,East Hararge,Kombolicha,4,87,15,106
Ginbot,9th,2009,Oromia,Bale,Sinana,76,0,41,117
Yekatit,6th,2009,Oromia,Adama Special Town,Adama Town,65,17,99,181
Ginbot,9th,2010,Oromia,Guji,Adola Town,80,75,24,179
Yekatit,6th,2011,Oromia,West Hararge,West Harerge	Gumbi Bordede,41,12,82,135
Nehase,12th,2010,Oromia,Buno Bedele,Gechi,44,8,62,114
Ginbot,9th,2009,Oromia,North Shewa,Aleiltu,78,87,32,197
Megabit,7th,2010,Oromia,Bale,Goba,12,68,68,148
Nehase,12th,2009,Oromia,West Shewa,Dendi,83,95,71,249
Miyazia,8th,2009,Oromia,East Hararge,Meta,88,50,80,218
Miyazia,8th,2010,Oromia,West Guji,Kercha Hospital,69,33,0,102
Hamle,11th,2010,Oromia,Arsi,Tena,15,67,5,87
Miyazia,8th,2009,Oromia,East Hararge,Meyu Muleke,9,19,79,107
Ginbot,9th,2011,Oromia,North Shewa,Wuchale,93,78,97,268
Yekatit,6th,2009,Oromia,Guji,Wadara,2,87,7,96
Yekatit,6th,2010,Oromia,Arsi,Dodota,64,79,24,167
Meskerem,1st,2010,Oromia,East Hararge,Babile,19,57,20,96
Miyazia,8th,2009,Oromia,West Wellega,Nejo Town,16,11,63,90
Sene,10th,2011,Oromia,West Shewa,Bako Hospital,44,43,47,134
Hedar,3rd,2010,Oromia,Arsi,Shirka,33,25,8,66
Sene,10th,2010,Oromia,Borena,Dubluk,16,13,29,58
Tahesas,4th,2011,Oromia,East Wellega,Haro Limu,78,4,67,149
Megabit,7th,2009,Oromia,Arsi,Guna,40,17,19,76
Hedar,3rd,2010,Oromia,South West Shewa,Sodo Dac'Ha,60,73,0,133
Ginbot,9th,2011,Oromia,Guji,Wadara,54,70,94,218
Megabit,7th,2009,Oromia,Bale,Gasera,72,73,17,162
Megabit,7th,2011,Oromia,West Wellega,Genji,59,39,79,177
Tir,5th,2011,Oromia,Ilu Aba Bora,Metu Rural,64,93,6,163
Hamle,11th,2009,Oromia,West Hararge,Meiso,13,51,25,89
Yekatit,6th,2010,Oromia,West Hararge,Daro Lebu,71,56,14,141
Sene,10th,2011,Oromia,Arsi,Chole,40,10,61,111
Yekatit,6th,2010,Oromia,South West Shewa,Seden Sodo,61,14,60,135
Miyazia,8th,2011,Oromia,West Shewa,Abuna Gindeberet,60,51,45,156
Nehase,12th,2010,Oromia,Jimma,Kersa,91,77,85,253
Megabit,7th,2010,Oromia,Ilu Aba Bora,Halu,8,94,77,179
Ginbot,9th,2011,Oromia,Ilu Aba Bora,Ale,52,21,66,139
Meskerem,1st,2010,Oromia,West Shewa,Jibat,15,15,57,87
Nehase,12th,2009,Oromia,South West Shewa,Dawo,45,10,85,140
Tir,5th,2011,Oromia,Ilu Aba Bora,Bure,91,0,1,92
Ginbot,9th,2011,Oromia,Guji,Aga Wayyu,82,90,67,239
Yekatit,6th,2011,Oromia,Arsi,Tena,98,85,16,199
Ginbot,9th,2009,Oromia,Jimma,Guma,26,98,81,205
Meskerem,1st,2010,Oromia,West Guji,Dugda Dawa,22,30,58,110
Tahesas,4th,2010,Oromia,Arsi,Chole,34,32,65,131
Nehase,12th,2010,Oromia,West Wellega,Lata Sibu,62,68,64,194
Sene,10th,2011,Oromia,Jimma,Dedo,55,61,0,116
Meskerem,1st,2010,Oromia,South West Shewa,Seden Sodo,36,93,67,196
Hedar,3rd,2011,Oromia,West Hararge,Bedesa Town,15,23,3,41
Sene,10th,2010,Oromia,North Shewa,Abichugna,27,72,39,138
Megabit,7th,2009,Oromia,East Wellega,Limu,49,49,74,172
Tir,5th,2011,Oromia,West Shewa,Meta Waliqite,48,80,97,225
Megabit,7th,2011,Oromia,West Arsi,Hebal Arsi,27,2,67,96
Tahesas,4th,2011,Oromia,South West Shewa,Woliso Rural,86,94,21,201
Miyazia,8th,2011,Oromia,West Shewa,Ambo Hospital,1,86,85,172
Miyazia,8th,2009,Oromia,West Arsi,Hebal Arsi,24,76,16,116
Hamle,11th,2010,Oromia,Jimma,O/Beyam,68,21,68,157
Tir,5th,2010,Oromia,North Shewa,Debre Libanos,32,78,3,113
Teqemt,2nd,2010,Oromia,East Wellega,Gida Ayana,57,58,8,123
Meskerem,1st,2011,Oromia,East Hararge,Kurfa Chele,68,8,45,121
Meskerem,1st,2010,Oromia,Bale,Raitu,15,62,73,150
Megabit,7th,2011,Oromia,West Shewa,Nono,8,72,72,152
Tir,5th,2011,Oromia,Borena,Wachile,40,35,71,146
Miyazia,8th,2011,Oromia,West Arsi,Bishan Guracha Town,94,81,64,239
Nehase,12th,2009,Oromia,Bale,Raitu,62,65,15,142
Nehase,12th,2010,Oromia,West Wellega,Nole Kaba,70,0,73,143
Miyazia,8th,2011,Oromia,East Shewa,Fentale,32,72,12,116
Ginbot,9th,2009,Oromia,East Hararge,Deder,14,36,86,136
Tir,5th,2009,Oromia,West Wellega,Nejo Hospital,74,19,5,98
Megabit,7th,2009,Oromia,West Shewa,Dano,44,83,24,151
Tir,5th,2011,Oromia,Arsi,Bale Gesgara,9,58,75,142
Hamle,11th,2009,Oromia,West Guji,Bule Hora Hospital,16,76,11,103
Hedar,3rd,2011,Oromia,West Shewa,Inchini Hospital,41,80,41,162
Megabit,7th,2010,Oromia,Jimma,Seka Chekorsa,87,70,83,240
Yekatit,6th,2009,Oromia,Borena,Dilo,84,57,86,227
Miyazia,8th,2010,Oromia,East Shewa,Bora,75,82,81,238
Teqemt,2nd,2011,Oromia,Guji,Wadara,52,21,18,91
Nehase,12th,2009,Oromia,Qeleme Wellega,Laloqile,50,77,89,216
Ginbot,9th,2011,Oromia,Horo Gudru Wellega,Jima Geneti,8,51,36,95
Ginbot,9th,2011,Oromia,West Wellega,Guliso,86,99,30,215
Ginbot,9th,2009,Oromia,West Shewa,Tibe Kutaye,86,63,45,194
Megabit,7th,2009,Oromia,North Shewa,Yaya Gulele,21,91,26,138
Miyazia,8th,2009,Oromia,Borena,Meyo,33,11,33,77
Hedar,3rd,2010,Oromia,West Shewa,Tikur Enchini,15,12,18,45
Ginbot,9th,2009,Oromia,Finfine Zuria,Akaki,96,61,36,193
Yekatit,6th,2011,Oromia,Bale,Arena Buluq,27,39,15,81
Nehase,12th,2010,Oromia,West Hararge,Boke,18,66,91,175
Yekatit,6th,2011,Oromia,Bale,Goba,59,60,22,141
Hedar,3rd,2010,Oromia,East Wellega,Gudeyabila,27,26,15,68
Hedar,3rd,2010,Oromia,Borena,Dilo,32,25,18,75
Ginbot,9th,2011,Oromia,Jimma,Guma,40,40,3,83
Teqemt,2nd,2010,Oromia,Ilu Aba Bora,Bilonopa,26,65,16,107
Tahesas,4th,2010,Oromia,West Shewa,Jibat,81,60,70,211
Ginbot,9th,2009,Oromia,West Wellega,Mendi Town,93,74,98,265
Megabit,7th,2011,Oromia,West Shewa,Bako Tibe,39,71,29,139
Nehase,12th,2010,Oromia,Arsi,Limuna Bilbilo,4,46,65,115
Miyazia,8th,2009,Oromia,East Shewa,Boset,14,72,99,185
Miyazia,8th,2011,Oromia,Borena,Dhas,82,82,95,259
Tir,5th,2011,Oromia,West Shewa,Abuna Gindeberet,4,43,53,100
Yekatit,6th,2011,Oromia,East Hararge,Gursum,98,37,80,215
Megabit,7th,2009,Oromia,Lege Dadi Lege Tafo Town,Lege Dadi Lege Tafo Town,82,0,42,124
Teqemt,2nd,2010,Oromia,Jimma,Sigmo,72,29,85,186
Tir,5th,2011,Oromia,West Shewa,Dano,32,2,65,99
Hedar,3rd,2010,Oromia,Ilu Aba Bora,Hurumu,39,88,16,143
Miyazia,8th,2011,Oromia,West Wellega,Mendi Hospital,78,78,54,210
Hedar,3rd,2010,Oromia,Modjo Town,Modjo Town,34,58,80,172
Miyazia,8th,2011,Oromia,West Guji,Mkelka Soda,98,40,9,147
Megabit,7th,2009,Oromia,West Shewa,Adea Berga,71,57,77,205
Nehase,12th,2010,Oromia,West Guji,Mkelka Soda,46,11,38,95
Ginbot,9th,2011,Oromia,Borena,Moyale Hospital,22,48,40,110
Tir,5th,2009,Oromia,Horo Gudru Wellega,Jarte Jardga,88,99,26,213
Yekatit,6th,2011,Oromia,Qeleme Wellega,Yemalogi Wolel,90,35,23,148
Sene,10th,2010,Oromia,West Wellega,Gimbi Adventist Hospital,4,20,82,106
Hedar,3rd,2010,Oromia,North Shewa,Abichugna,73,75,75,223
Hamle,11th,2010,Oromia,Guji,Bore,93,10,18,121
Yekatit,6th,2010,Oromia,Arsi,Munesa,20,62,8,90
Ginbot,9th,2011,Oromia,West Arsi,Dodola Rural,29,23,84,136
Nehase,12th,2010,Oromia,Jimma,Omo Nada Hospital,33,65,86,184
Ginbot,9th,2010,Oromia,Ilu Aba Bora,Metu Rural,54,99,21,174
Meskerem,1st,2011,Oromia,Lege Dadi Lege Tafo Town,Lege Dadi Lege Tafo Town,97,78,26,201
Hedar,3rd,2010,Oromia,North Shewa,Jido,30,71,13,114
Sene,10th,2009,Oromia,Bale,Gura Dhamole,43,55,28,126
Ginbot,9th,2009,Oromia,Qeleme Wellega,Jimma Horo,78,36,92,206
Tir,5th,2011,Oromia,South West Shewa,Goro,35,71,18,124
Hedar,3rd,2010,Oromia,West Shewa,Jeldu,73,10,12,95
Nehase,12th,2009,Oromia,West Arsi,Adaba,53,23,7,83
Nehase,12th,2009,Oromia,Borena,Yabelo Rural,12,2,45,59
Hamle,11th,2010,Oromia,Guji,Saba Boru,56,44,3,103
Megabit,7th,2010,Oromia,East Hararge,Aweday Town,17,57,54,128
Megabit,7th,2009,Oromia,East Hararge,Goro Gutu,81,31,23,135
Tahesas,4th,2011,Oromia,South West Shewa,Dawo,44,29,5,78
Ginbot,9th,2010,Oromia,East Hararge,Haromaya Hospital,12,74,27,113
Sene,10th,2011,Oromia,West Hararge,Chiro Zuriya,22,20,19,61
Meskerem,1st,2011,Oromia,Buno Bedele,Boricha,98,41,97,236
Sene,10th,2011,Oromia,East Hararge,Kumbi,49,62,85,196
Miyazia,8th,2010,Oromia,West Shewa,Jeldu,0,28,50,78
Hamle,11th,2009,Oromia,Jimma,Mana,25,35,70,130
Tir,5th,2010,Oromia,East Wellega,Kiremu,26,50,27,103
Yekatit,6th,2009,Oromia,North Shewa,Kimbibit,47,53,97,197
Tahesas,4th,2011,Oromia,North Shewa,Fichetown,87,82,77,246
Tir,5th,2010,Oromia,Jimma,Gomma,5,91,46,142
Megabit,7th,2011,Oromia,Bale,Delo Mena,64,74,89,227
Sene,10th,2011,Oromia,West Wellega,Ayira,58,84,24,166
Meskerem,1st,2010,Oromia,East Hararge,Goro Gutu,46,23,86,155
Miyazia,8th,2010,Oromia,Qeleme Wellega,Gawo Qebe,75,57,45,177
Ginbot,9th,2010,Oromia,Arsi,Digeluna Tijo,92,51,5,148
Teqemt,2nd,2011,Oromia,Bale,Meda Welabu,15,95,42,152
Ginbot,9th,2009,Oromia,Borena,El Way,62,27,59,148
Ginbot,9th,2011,Oromia,West Arsi,Kofele,16,23,20,59
Sene,10th,2009,Oromia,West Arsi,Kofele,74,74,23,171
Tir,5th,2010,Oromia,West Arsi,Kore,32,28,3,63
Megabit,7th,2011,Oromia,Borena,Teltele,78,84,60,222
Hamle,11th,2010,Oromia,North Shewa,Degem,62,1,36,99
Tir,5th,2009,Oromia,East Hararge,Melka Belo,82,45,53,180
Nehase,12th,2010,Oromia,West Guji,Hanbala,76,6,26,108
Meskerem,1st,2011,Oromia,Ilu Aba Bora,Metu Town,67,41,66,174
Sene,10th,2011,Oromia,Bale,Dawe Qachen,44,18,73,135
Miyazia,8th,2009,Oromia,Guji,Goro Dola,74,88,51,213
Tir,5th,2011,Oromia,East Shewa,Dugda,16,39,37,92
Yekatit,6th,2011,Oromia,Qeleme Wellega,Sedan Chanka,61,58,3,122
Miyazia,8th,2011,Oromia,Qeleme Wellega,Anfilo,32,42,30,104
Nehase,12th,2009,Oromia,South West Shewa,St.Luke Hospital,64,45,46,155
Ginbot,9th,2011,Oromia,West Guji,Suro Barguda,23,25,71,119
Yekatit,6th,2009,Oromia,Jimma,Limu Kosa,13,78,99,190
Nehase,12th,2010,Oromia,West Hararge,Gemechis,13,1,12,26
Teqemt,2nd,2010,Oromia,West Arsi,Siraro,52,26,15,93
Nehase,12th,2010,Oromia,North Shewa,Kuyu Hospital,39,7,5,51
Ginbot,9th,2011,Oromia,Bale,Berbere,77,26,40,143
Tahesas,4th,2011,Oromia,South West Shewa,Dawo,6,62,44,112
Teqemt,2nd,2010,Oromia,Guji,Odo Shakiso,80,68,50,198
Tahesas,4th,2011,Oromia,Adama Special Town,Adama Town,4,1,48,53
Nehase,12th,2010,Oromia,West Wellega,Ayira,56,18,97,171
Nehase,12th,2010,Oromia,Qeleme Wellega,Gawo Qebe,1,8,55,64
Sene,10th,2009,Oromia,West Shewa,Ambo Town,7,93,18,118
Sene,10th,2009,Oromia,West Wellega,Gimbi Adventist Hospital,55,70,54,179
Miyazia,8th,2010,Oromia,Ilu Aba Bora,Ale,69,46,31,146
Ginbot,9th,2009,Oromia,East Hararge,Haromaya Rural,6,10,27,43
Nehase,12th,2009,Oromia,Qeleme Wellega,Yemalogi Wolel,77,55,51,183
Hedar,3rd,2010,Oromia,Bale,Gasera,38,93,90,221
Teqemt,2nd,2010,Oromia,West Wellega,Nejo Rural,98,56,38,192
Yekatit,6th,2011,Oromia,Borena,El Way,8,27,12,47
Hamle,11th,2010,Oromia,West Wellega,Mene Sibu,20,15,34,69
Ginbot,9th,2009,Oromia,West Arsi,Kofele,8,44,99,151
Yekatit,6th,2010,Oromia,Buno Bedele,Boricha,38,87,32,157
Hamle,11th,2009,Oromia,Arsi,Robe,7,56,29,92
Ginbot,9th,2011,Oromia,Arsi,Gololcha,85,97,10,192
Miyazia,8th,2009,Oromia,East Wellega,Gobu Seyo,93,8,77,178
Hedar,3rd,2011,Oromia,West Shewa,Gojo Hospital,1,52,91,144
Tir,5th,2009,Oromia,West Shewa,Liban Jawi,57,30,45,132
Hamle,11th,2009,Oromia,Arsi,Limuna Bilbilo,10,84,80,174
Teqemt,2nd,2010,Oromia,East Wellega,Nunu Qumba,67,53,52,172
Hedar,3rd,2010,Oromia,Ilu Aba Bora,Yayu,52,3,65,120
Yekatit,6th,2010,Oromia,Finfine Zuria,Sandefa,46,93,18,157
Megabit,7th,2010,Oromia,Ilu Aba Bora,Becho,80,94,70,244
Tahesas,4th,2010,Oromia,West Wellega,Mendi Hospital,69,68,7,144
Nehase,12th,2009,Oromia,West Arsi,Adaba,96,80,95,271
Sene,10th,2011,Oromia,Borena,Dhas,39,50,91,180
Megabit,7th,2011,Oromia,Gelan Town,Gelan Town,34,89,55,178
Meskerem,1st,2010,Oromia,South West Shewa,Tole,6,26,83,115
Yekatit,6th,2009,Oromia,East Wellega,Haro Limu,18,76,31,125
Yekatit,6th,2009,Oromia,East Wellega,Sibu Sire,76,25,90,191
Yekatit,6th,2010,Oromia,Finfine Zuria,Akaki,62,77,51,190
Sene,10th,2011,Oromia,East Hararge,Haromaya Rural,6,81,92,179
Tahesas,4th,2011,Oromia,Guji,Liben,27,95,34,156
Hamle,11th,2009,Oromia,West Wellega,Boji Dermeji,51,75,57,183
Tir,5th,2011,Oromia,East Hararge,Melka Belo,92,37,94,223
Hamle,11th,2009,Oromia,West Hararge,Hawi Gudina,5,56,71,132
Sene,10th,2010,Oromia,Guji,Negele Town,34,34,8,76
Megabit,7th,2009,Oromia,West Arsi,Arsi Negele Town,24,48,66,138
Megabit,7th,2010,Oromia,Ilu Aba Bora,Bilonopa,15,19,89,123
Megabit,7th,2010,Oromia,East Hararge,Chelenko Hospital,29,98,69,196
Hamle,11th,2010,Oromia,North Shewa,Wuchale,73,34,69,176
Ginbot,9th,2011,Oromia,West Hararge,Bedesa Town,78,32,79,189
Sene,10th,2011,Oromia,East Wellega,Gida Ayana,6,85,20,111
Teqemt,2nd,2010,Oromia,West Shewa,Gojo Hospital,61,39,49,149
Sene,10th,2011,Oromia,West Arsi,Bishan Guracha Town,7,36,34,77
Nehase,12th,2010,Oromia,West Wellega,Gimbi Rural,20,13,26,59
Hedar,3rd,2011,Oromia,West Guji,Gelana,88,93,76,257
Megabit,7th,2011,Oromia,North Shewa,Dera Hospital,94,18,43,155
Ginbot,9th,2011,Oromia,Ilu Aba Bora,Doreni,17,17,54,88
Miyazia,8th,2011,Oromia,East Hararge,Kurfa Chele,39,79,6,124
Sene,10th,2011,Oromia,West Guji,Biebirsa Kojowa,94,43,74,211
Tahesas,4th,2011,Oromia,Jimma,Tiro Afeta,39,98,59,196
Hedar,3rd,2010,Oromia,West Arsi,Adaba,42,51,59,152
Tir,5th,2010,Oromia,Jimma,Agaro,7,53,60,120
Meskerem,1st,2011,Oromia,West Hararge,Habro,29,1,57,87
Miyazia,8th,2009,Oromia,West Hararge,Guba Qoricha,49,40,24,113
Meskerem,1st,2011,Oromia,East Shewa,Lomme,56,95,33,184
Sene,10th,2010,Oromia,East Hararge,Babile Woreda,83,91,70,244
Miyazia,8th,2010,Oromia,Ilu Aba Bora,Hurumu,13,76,69,158
Sene,10th,2010,Oromia,Ilu Aba Bora,Algesachi,78,16,96,190
Ginbot,9th,2010,Oromia,Bale,Goba Town,86,58,26,170
Hedar,3rd,2010,Oromia,West Wellega,Gimbi,3,92,45,140
Tir,5th,2011,Oromia,Bale,Agarfa,43,14,29,86
Teqemt,2nd,2010,Oromia,Buno Bedele,Gechi,13,57,83,153
Sene,10th,2009,Oromia,East Hararge,Goro Gutu,92,84,78,254
Meskerem,1st,2011,Oromia,East Shewa,Adami Tulu Jido Kombolcha,41,22,54,117
Nehase,12th,2010,Oromia,Guji,Bore Hospital,11,73,8,92
Hedar,3rd,2011,Oromia,West Wellega,Boji Cheqorsa,70,30,33,133
Hamle,11th,2010,Oromia,Borena,Wachile,70,15,9,94
Miyazia,8th,2010,Oromia,Jimma,Sigmo,43,88,43,174
Sene,10th,2010,Oromia,South West Shewa,St.Luke Hospital,35,10,41,86
Yekatit,6th,2009,Oromia,North Shewa,Aleiltu,34,75,87,196
Tir,5th,2011,Oromia,Ilu Aba Bora,Halu,47,7,70,124
Miyazia,8th,2009,Oromia,West Shewa,Ginde Beret,37,67,81,185
Sene,10th,2009,Oromia,Arsi,Zeway Dugda,70,95,81,246
Teqemt,2nd,2011,Oromia,West Shewa,Meta Waliqite,80,71,3,154
Hedar,3rd,2010,Oromia,Guji,Girja,90,80,61,231
Hamle,11th,2009,Oromia,Bale,Meda Welabu,21,81,28,130
Hedar,3rd,2011,Oromia,West Guji,Suro Barguda,8,97,56,161
Tir,5th,2010,Oromia,South West Shewa,Becho,12,93,95,200
Megabit,7th,2011,Oromia,Jimma,Dedo,37,96,73,206
Hedar,3rd,2010,Oromia,East Wellega,Sasiga,68,95,59,222
Sene,10th,2011,Oromia,Arsi,Deksis,25,73,9,107
Ginbot,9th,2010,Oromia,West Arsi,Gambo Hospital,74,4,9,87
Hamle,11th,2010,Oromia,Borena,Yabelo,36,67,60,163
Miyazia,8th,2011,Oromia,Arsi,Amigna,6,19,6,31
Megabit,7th,2010,Oromia,Jimma,Mancho,38,79,3,120
Megabit,7th,2011,Oromia,East Shewa,Dugda,65,25,79,169
Nehase,12th,2009,Oromia,North Shewa,Abichugna,68,56,46,170
Ginbot,9th,2011,Oromia,North Shewa,Fichetown,48,55,66,169
Tir,5th,2011,Oromia,East Shewa,Adama,74,94,82,250
Megabit,7th,2009,Oromia,Arsi,Sude,85,72,32,189
Hedar,3rd,2011,Oromia,Qeleme Wellega,Dambi Dollo,48,33,14,95
Yekatit,6th,2011,Oromia,South West Shewa,St.Luke Hospital,34,53,44,131
Yekatit,6th,2009,Oromia,Buno Bedele,Gechi,47,71,47,165
Ginbot,9th,2010,Oromia,Bale,Gura Dhamole,26,29,98,153
Tir,5th,2009,Oromia,West Hararge,Chiro Hospital,51,67,22,140
Teqemt,2nd,2011,Oromia,Jimma,Chora Boter,20,60,56,136
Tahesas,4th,2011,Oromia,Ilu Aba Bora,Nono Sele,86,18,33,137
Tahesas,4th,2010,Oromia,West Hararge,Mesela,89,87,98,274
Megabit,7th,2011,Oromia,East Shewa,Fentale,34,35,76,145
Tir,5th,2009,Oromia,South West Shewa,Becho,5,64,64,133
Ginbot,9th,2010,Oromia,Bale,Arena Buluq,74,94,26,194
Megabit,7th,2010,Oromia,Borena,Yabelo Rural,84,43,9,136
Nehase,12th,2010,Oromia,East Hararge,Kumbi,90,31,10,131
Ginbot,9th,2011,Oromia,Jimma,Omo Nada Hospital,11,58,38,107
Yekatit,6th,2011,Oromia,East Hararge,Gole Oda,73,39,51,163
Hamle,11th,2009,Oromia,East Wellega,Limu,5,12,33,50
Ginbot,9th,2010,Oromia,Bale,Goba,47,81,0,128
Hamle,11th,2010,Oromia,Borena,Dilo,91,12,38,141
Yekatit,6th,2010,Oromia,Bale,Gura Dhamole,80,83,80,243
Hedar,3rd,2010,Oromia,West Guji,Gelana,32,56,64,152
Tir,5th,2009,Oromia,North Shewa,Yaya Gulele,87,90,74,251
Megabit,7th,2010,Oromia,West Arsi,Kokosa  Hospital,87,50,95,232
Hedar,3rd,2011,Oromia,Buno Bedele,Bedele Hospital,76,88,98,262
Sene,10th,2011,Oromia,Borena,Meyo,83,81,3,167
Ginbot,9th,2010,Oromia,West Shewa,Jeldu,2,62,65,129
Hamle,11th,2010,Oromia,Buno Bedele,Boricha,33,75,28,136
Ginbot,9th,2009,Oromia,Ilu Aba Bora,Nono Sele,32,48,45,125
Tir,5th,2010,Oromia,Buno Bedele,Meko,78,67,41,186
Teqemt,2nd,2010,Oromia,Horo Gudru Wellega,Gudru,14,82,41,137
Tir,5th,2010,Oromia,West Guji,Abaya,26,68,88,182
Meskerem,1st,2011,Oromia,West Guji,Abaya,73,54,33,160
Hedar,3rd,2010,Oromia,West Shewa,Liban Jawi,6,31,10,47
Megabit,7th,2010,Oromia,Buno Bedele,Bedele Town,65,6,37,108
Tir,5th,2010,Oromia,West Wellega,Boji Cheqorsa,96,86,83,265
Tahesas,4th,2010,Oromia,Arsi,Munesa,58,16,80,154
Tir,5th,2011,Oromia,East Wellega,Limu,68,18,14,100
Hedar,3rd,2010,Oromia,West Shewa,Nono,87,68,68,223
Megabit,7th,2011,Oromia,Bale,Goro,96,3,89,188
Ginbot,9th,2011,Oromia,Guji,Girja,14,31,11,56
Ginbot,9th,2010,Oromia,Bale,Agarfa,74,97,16,187
Sene,10th,2011,Oromia,West Hararge,Gemechis,26,85,77,188
Hedar,3rd,2010,Oromia,Buno Bedele,Bedele Town,55,38,0,93
Hedar,3rd,2010,Oromia,Borena,Guchi,86,59,76,221
Tahesas,4th,2011,Oromia,West Arsi,Wondo,76,73,90,239
Megabit,7th,2010,Oromia,West Wellega,Gimbi Public  Hospital,18,31,58,107
Miyazia,8th,2010,Oromia,West Wellega,Kundala,14,33,2,49
Nehase,12th,2010,Oromia,West Shewa,Ginde Beret,37,43,86,166
Sene,10th,2010,Oromia,Jimma,Kersa,78,80,10,168
Yekatit,6th,2009,Oromia,East Wellega,Boneya Bushe,63,78,0,141
Tir,5th,2009,Oromia,West Wellega,Gimbi Rural,47,92,81,220
Miyazia,8th,2010,Oromia,Qeleme Wellega,Gidami,76,29,15,120
Miyazia,8th,2011,Oromia,West Shewa,Gedo Hospital,33,49,79,161
Hedar,3rd,2010,Oromia,Arsi,Munesa,63,21,83,167
Yekatit,6th,2009,Oromia,Ilu Aba Bora,Yayu,69,37,69,175
Miyazia,8th,2009,Oromia,West Guji,Bule Hora Hospital,9,29,80,118
Megabit,7th,2011,Oromia,West Arsi,Gedeb Asasa,14,25,29,68
Megabit,7th,2011,Oromia,Jimma,Shabe,59,78,44,181
Sene,10th,2011,Oromia,East Shewa,Matahara,42,2,66,110
Miyazia,8th,2010,Oromia,East Hararge,Jarso,72,31,25,128
Ginbot,9th,2011,Oromia,Guji,Shakiso Town,75,51,98,224
Sene,10th,2009,Oromia,East Wellega,Sasiga,38,66,76,180
Tir,5th,2010,Oromia,South West Shewa,Dawo,11,53,9,73
Hamle,11th,2010,Oromia,Arsi,Merti,44,1,33,78
Teqemt,2nd,2010,Oromia,West Shewa,Gindeberet Hospital,70,4,19,93
Yekatit,6th,2011,Oromia,West Wellega,Haru,27,61,41,129
Tir,5th,2011,Oromia,Borena,Dhas,90,49,19,158
Tahesas,4th,2011,Oromia,Guji,Bore Hospital,15,73,8,96
Ginbot,9th,2011,Oromia,Guji,Liben,87,91,47,225
Megabit,7th,2009,Oromia,West Shewa,Ejersa Lafo,15,14,50,79
Ginbot,9th,2010,Oromia,Guji,Aga Wayyu,6,85,90,181
Miyazia,8th,2010,Oromia,West Wellega,Kundala,18,44,36,98
Meskerem,1st,2010,Oromia,Borena,Wachile,3,77,5,85
Megabit,7th,2011,Oromia,Qeleme Wellega,Gawo Qebe,33,9,97,139
Yekatit,6th,2009,Oromia,West Shewa,Chelia,70,32,65,167
Sene,10th,2009,Oromia,West Guji,Bule Hora Hospital,34,67,49,150
Ginbot,9th,2011,Oromia,Arsi,Munesa,41,25,33,99
Hedar,3rd,2010,Oromia,East Wellega,Boneya Bushe,16,69,84,169
Sene,10th,2009,Oromia,East Hararge,Gursum,12,0,19,31
Hedar,3rd,2011,Oromia,Guji,Dima,29,43,86,158
Hedar,3rd,2011,Oromia,West Wellega,Homa,68,17,74,159
Megabit,7th,2010,Oromia,West Guji,Hanbala,8,2,9,19
Yekatit,6th,2011,Oromia,Bale,Gura Dhamole,55,8,84,147
Megabit,7th,2010,Oromia,Assela Town,Assela Town,23,85,1,109
Yekatit,6th,2009,Oromia,West Hararge,Anchar,19,26,85,130
Ginbot,9th,2009,Oromia,East Hararge,Kersa Eh,31,69,86,186
Hedar,3rd,2010,Oromia,Jimma,Gera,13,26,18,57
Tir,5th,2011,Oromia,East Shewa,Matahara,67,61,17,145
Yekatit,6th,2011,Oromia,West Shewa,Tibe Kutaye,57,44,40,141
Megabit,7th,2009,Oromia,East Shewa,Dugda,1,85,46,132
Nehase,12th,2010,Oromia,West Hararge,Bedesa Town,43,71,8,122
Meskerem,1st,2010,Oromia,West Wellega,Qiltu Kara,0,97,59,156
Nehase,12th,2009,Oromia,West Wellega,Gimbi Adventist Hospital,61,53,1,115
Nehase,12th,2009,Oromia,Arsi,Bale Gesgara,7,62,87,156
Teqemt,2nd,2010,Oromia,West Hararge,Doba,23,96,73,192
Miyazia,8th,2010,Oromia,Qeleme Wellega,Sedan Chanka,45,47,33,125
Megabit,7th,2009,Oromia,Arsi,Zeway Dugda,79,95,37,211
Nehase,12th,2010,Oromia,West Arsi,Dodola Rural,36,38,17,91
Ginbot,9th,2009,Oromia,Bale,Goro,83,58,72,213
Megabit,7th,2010,Oromia,East Shewa,Matahara,85,49,55,189
Yekatit,6th,2011,Oromia,East Hararge,Deder Hospital,76,55,13,144
Nehase,12th,2009,Oromia,Bale,Robe Town,75,63,30,168
Miyazia,8th,2010,Oromia,Buno Bedele,Dapho Hana,25,98,81,204
Miyazia,8th,2011,Oromia,North Shewa,Dera Hospital,11,22,79,112
Nehase,12th,2009,Oromia,West Wellega,Gimbi,56,69,28,153
Miyazia,8th,2011,Oromia,West Shewa,Gindeberet Hospital,28,50,52,130
Hedar,3rd,2011,Oromia,Jimma,Omo Nada Hospital,7,27,72,106
Nehase,12th,2010,Oromia,East Wellega,Sasiga,78,3,84,165
Tahesas,4th,2011,Oromia,West Wellega,Gimbi Public  Hospital,99,31,11,141
Hedar,3rd,2010,Oromia,Arsi,Aseko,17,99,15,131
Sene,10th,2011,Oromia,Borena,El Way,78,39,7,124
Sene,10th,2009,Oromia,Finfine Zuria,Berreh,37,58,6,101
Ginbot,9th,2011,Oromia,Arsi,Limuna Bilbilo,57,76,11,144
Meskerem,1st,2011,Oromia,Borena,Yabelo Hospital,42,32,97,171
Sene,10th,2009,Oromia,North Shewa,Dera Hospital,57,94,81,232
Tahesas,4th,2010,Oromia,North Shewa,Abichugna,83,40,54,177
Megabit,7th,2011,Oromia,Jimma,Limu Seka,60,20,11,91
Nehase,12th,2009,Oromia,West Wellega,Nole Kaba,89,69,58,216
Nehase,12th,2010,Oromia,North Shewa,Hidabu Abote,7,11,40,58
Teqemt,2nd,2010,Oromia,Buno Bedele,Bedele Hospital,7,30,17,54
Hedar,3rd,2010,Oromia,East Hararge,Deder Town,43,0,60,103
Miyazia,8th,2009,Oromia,West Hararge,Oda Bultum,89,2,86,177
Miyazia,8th,2010,Oromia,Borena,Guchi,36,15,10,61
Megabit,7th,2009,Oromia,West Shewa,Liban Jawi,63,38,78,179
Megabit,7th,2009,Oromia,West Arsi,Arsi Negele Rural,58,23,70,151
Tir,5th,2010,Oromia,North Shewa,Kimbibit,85,80,48,213
Meskerem,1st,2010,Oromia,South West Shewa,Ilu,60,80,81,221
Ginbot,9th,2010,Oromia,Borena,Dilo,22,40,41,103
Sene,10th,2011,Oromia,East Wellega,Haro Limu,27,98,43,168
Miyazia,8th,2009,Oromia,West Wellega,Begi Hospital,98,70,50,218
Meskerem,1st,2011,Oromia,West Guji,Kercha Hospital,82,96,29,207
Sene,10th,2009,Oromia,Jimma,Dedo,51,82,74,207
Tir,5th,2011,Oromia,Gelan Town,Gelan Town,26,56,10,92
Nehase,12th,2010,Oromia,East Hararge,Gole Oda,57,45,2,104
Nehase,12th,2010,Oromia,Guji,Goro Dola,17,71,31,119
Tir,5th,2009,Oromia,West Shewa,Inchini Hospital,22,73,55,150
Yekatit,6th,2010,Oromia,East Shewa,Dugda,93,88,70,251
Sene,10th,2010,Oromia,East Hararge,Gursum,99,52,35,186
Nehase,12th,2010,Oromia,Guji,Liben,11,12,42,65
Meskerem,1st,2011,Oromia,Borena,Dire,47,12,70,129
Hedar,3rd,2010,Oromia,West Shewa,Ejerie,23,69,4,96
Hedar,3rd,2010,Oromia,West Wellega,Lata Sibu,35,2,53,90
Meskerem,1st,2011,Oromia,East Hararge,Haromaya Rural,32,38,34,104
Sene,10th,2009,Oromia,North Shewa,Dera Hospital,15,85,29,129
Megabit,7th,2009,Oromia,West Shewa,Jibat,68,97,23,188
Sene,10th,2010,Oromia,Qeleme Wellega,Anfilo,39,74,15,128
Nehase,12th,2009,Oromia,Jimma,Limu Seka,8,53,1,62
Tir,5th,2009,Oromia,Guji,Adola Hospital,66,14,25,105
Yekatit,6th,2010,Oromia,East Hararge,Bisidimo Hospital,60,98,78,236
Hamle,11th,2009,Oromia,East Hararge,Bedeno,36,12,66,114
Megabit,7th,2010,Oromia,East Hararge,Haromaya Town,98,88,78,264
Miyazia,8th,2011,Oromia,Arsi,Enkelo Wabe,19,81,96,196
Ginbot,9th,2009,Oromia,Jimma,Chora Boter,13,47,35,95
Sene,10th,2010,Oromia,West Shewa,Ambo,48,19,28,95
Tir,5th,2010,Oromia,West Guji,Kercha,36,17,48,101
Ginbot,9th,2009,Oromia,Arsi,Ludehetosa,19,22,96,137
Teqemt,2nd,2011,Oromia,Bale,Arena Buluq,84,69,20,173
Sene,10th,2010,Oromia,East Hararge,Kurfa Chele,85,89,0,174
Ginbot,9th,2009,Oromia,Finfine Zuria,Mullo,64,84,91,239
Miyazia,8th,2009,Oromia,West Wellega,Haru,89,78,9,176
Yekatit,6th,2009,Oromia,East Hararge,Garemuleta Hospital,18,63,32,113
Nehase,12th,2010,Oromia,Jimma,Kersa,89,41,85,215
Tahesas,4th,2010,Oromia,West Shewa,Adea Berga,17,3,74,94
Tahesas,4th,2010,Oromia,East Wellega,Wayu Tuqa,16,37,86,139
Meskerem,1st,2011,Oromia,West Wellega,Nole Kaba,45,55,31,131
Ginbot,9th,2009,Oromia,South West Shewa,Tole,96,68,34,198
Hamle,11th,2009,Oromia,West Wellega,Mendi Hospital,67,46,53,166
Nehase,12th,2010,Oromia,East Hararge,Deder,63,69,70,202
Teqemt,2nd,2011,Oromia,East Wellega,Leqa Dulecha,68,70,69,207
Ginbot,9th,2010,Oromia,Lege Dadi Lege Tafo Town,Lege Dadi Lege Tafo Town,37,74,68,179
Yekatit,6th,2010,Oromia,Bale,Ginir Town,66,89,35,190
Nehase,12th,2009,Oromia,North Shewa,Kuyu Hospital,27,78,39,144
Yekatit,6th,2010,Oromia,North Shewa,Fichetown,82,59,72,213
Tahesas,4th,2010,Oromia,Arsi,Merti,50,87,20,157
Tir,5th,2009,Oromia,West Hararge,West Harerge	Gumbi Bordede,6,12,91,109
Yekatit,6th,2011,Oromia,Arsi,Hitosa,74,70,18,162
Megabit,7th,2010,Oromia,North Shewa,Debre Libanos,28,49,94,171
Nehase,12th,2009,Oromia,Ilu Aba Bora,Doreni,33,76,77,186
Ginbot,9th,2011,Oromia,Arsi,Ludehetosa,74,55,77,206
Miyazia,8th,2009,Oromia,East Wellega,Gudeyabila,34,90,83,207
Miyazia,8th,2009,Oromia,Arsi,Tiyo,93,3,96,192
Tir,5th,2011,Oromia,Bale,Arena Buluq,25,53,11,89
Meskerem,1st,2011,Oromia,Qeleme Wellega,Gidami,68,0,40,108
Nehase,12th,2009,Oromia,Borena,Yabelo,21,68,58,147
Teqemt,2nd,2010,Oromia,Bale,Dawe Serar,51,25,94,170
Tir,5th,2009,Oromia,West Hararge,Oda Bultum,24,2,62,88
Megabit,7th,2011,Oromia,Buno Bedele,Bedele Zuriya,48,11,49,108
Megabit,7th,2011,Oromia,Nekemte Town,Nekemte Town,30,80,74,184
Miyazia,8th,2011,Oromia,West Wellega,Seyo Nole,19,83,77,179
Megabit,7th,2010,Oromia,West Arsi,Kokosa  Hospital,4,10,59,73
Miyazia,8th,2011,Oromia,Ilu Aba Bora,Doreni,98,77,62,237
Tir,5th,2010,Oromia,Jimma,Limu Seka,60,41,14,115
Megabit,7th,2010,Oromia,West Guji,Mkelka Soda,32,97,46,175
Teqemt,2nd,2011,Oromia,Ilu Aba Bora,Hurumu,73,96,16,185
Miyazia,8th,2009,Oromia,Guji,Uraga,6,19,38,63
Teqemt,2nd,2010,Oromia,Jimma,Sekoru,23,86,34,143
Teqemt,2nd,2011,Oromia,Bale,Goro,97,75,7,179
Miyazia,8th,2010,Oromia,Finfine Zuria,Sululta Town,61,29,83,173
Tir,5th,2011,Oromia,Guji,Adola Hospital,63,26,79,168
Ginbot,9th,2009,Oromia,South West Shewa,Woliso Town,18,76,95,189
Teqemt,2nd,2010,Oromia,Guji,Negele Town,55,86,25,166
Miyazia,8th,2010,Oromia,Arsi,Sude,28,15,85,128
Ginbot,9th,2009,Oromia,West Arsi,Nensebo,80,65,25,170
Miyazia,8th,2010,Oromia,West Guji,Bule Hora Toun,4,79,78,161
Yekatit,6th,2009,Oromia,Horo Gudru Wellega,Abe Dengoro,28,79,75,182
Nehase,12th,2009,Oromia,Arsi,Jeju,80,0,7,87
Nehase,12th,2009,Oromia,West Hararge,Bedesa Town,35,23,72,130
Hedar,3rd,2011,Oromia,Arsi,Gololcha,72,4,58,134
Hamle,11th,2010,Oromia,East Hararge,Kombolicha,67,41,68,176
Hedar,3rd,2011,Oromia,Guji,Bore Hospital,99,37,81,217
Tir,5th,2010,Oromia,Qeleme Wellega,Jimma Horo,36,60,63,159
Nehase,12th,2009,Oromia,East Hararge,Kersa Eh,81,45,64,190
Ginbot,9th,2011,Oromia,North Shewa,Debre Libanos,94,31,82,207
Meskerem,1st,2011,Oromia,South West Shewa,Tole,81,18,24,123
Sene,10th,2009,Oromia,East Wellega,Limu,36,77,51,164
Hedar,3rd,2011,Oromia,West Hararge,Chiro Town,28,55,92,175
Ginbot,9th,2011,Oromia,Finfine Zuria,Sebeta Awas,40,79,76,195
Tahesas,4th,2011,Oromia,West Arsi,Adaba,33,59,4,96
Teqemt,2nd,2011,Oromia,North Shewa,Degem,25,40,7,72
Yekatit,6th,2009,Oromia,Guji,Uraga,9,85,53,147
Yekatit,6th,2011,Oromia,Arsi,Bale Gesgara,82,79,77,238
Yekatit,6th,2010,Oromia,East Hararge,Fedis,13,6,36,55
Teqemt,2nd,2010,Oromia,Bale,Ginir,40,67,84,191
Teqemt,2nd,2011,Oromia,Qeleme Wellega,Gidami Hosp,44,83,8,135
Ginbot,9th,2009,Oromia,West Wellega,Boji Cheqorsa,83,35,83,201
Tir,5th,2009,Oromia,Arsi,Sire,26,12,53,91
Nehase,12th,2010,Oromia,Arsi,Ludehetosa,77,88,36,201
Megabit,7th,2010,Oromia,Finfine Zuria,Walmera,65,5,24,94
Hamle,11th,2009,Oromia,Arsi,Hitosa,4,90,28,122
Ginbot,9th,2010,Oromia,Borena,Gomole,22,80,39,141
Ginbot,9th,2009,Oromia,Guji,Adola Reda,41,80,22,143
Nehase,12th,2009,Oromia,Buno Bedele,Bedele Town,45,66,96,207
Sene,10th,2009,Oromia,Qeleme Wellega,Jimma Horo,26,62,75,163
Teqemt,2nd,2010,Oromia,East Wellega,Nunu Qumba,73,21,1,95
Hedar,3rd,2010,Oromia,West Wellega,Lata Sibu,58,71,80,209
Yekatit,6th,2009,Oromia,South West Shewa,Ameya,67,24,0,91
Megabit,7th,2010,Oromia,Arsi,Zeway Dugda,12,98,39,149
Yekatit,6th,2011,Oromia,Jimma,Mana,72,28,20,120
Miyazia,8th,2011,Oromia,Jimma,Dedo,68,16,56,140
Ginbot,9th,2009,Oromia,Gelan Town,Gelan Town,5,57,43,105
Yekatit,6th,2009,Oromia,Arsi,Zeway Dugda,47,92,78,217
Tir,5th,2010,Oromia,Arsi,Merti,32,65,91,188
Teqemt,2nd,2011,Oromia,West Hararge,West Harerge	Gumbi Bordede,44,74,69,187
Meskerem,1st,2011,Oromia,West Guji,Bule Hora Toun,84,0,53,137
Sene,10th,2009,Oromia,West Arsi,Adaba,97,29,31,157
Miyazia,8th,2009,Oromia,Finfine Zuria,Berreh,63,35,13,111
Tahesas,4th,2010,Oromia,Guji,Negele Hospital,10,58,71,139
Miyazia,8th,2010,Oromia,West Arsi,Kore,95,49,96,240
Yekatit,6th,2011,Oromia,Jimma,Guma,95,22,68,185
Sene,10th,2009,Oromia,Arsi,Gololcha,85,53,36,174
Yekatit,6th,2010,Oromia,Guji,Negele Hospital,56,96,97,249
Miyazia,8th,2009,Oromia,West Arsi,Gambo Hospital,3,68,43,114
Yekatit,6th,2011,Oromia,East Shewa,Liben,19,37,91,147
Nehase,12th,2010,Oromia,West Shewa,Bako Tibe,15,84,70,169
Yekatit,6th,2010,Oromia,Arsi,Tiyo,26,5,44,75
Hamle,11th,2009,Oromia,Jimma,Omonada,12,32,69,113
Tir,5th,2011,Oromia,South West Shewa,Ameya Hospital,2,23,87,112
Megabit,7th,2011,Oromia,East Wellega,Wama Hagelo,9,78,32,119
Hedar,3rd,2011,Oromia,North Shewa,Fiche Hospital,28,3,77,108
Ginbot,9th,2010,Oromia,West Arsi,Kokosa,80,10,14,104
Ginbot,9th,2010,Oromia,East Hararge,Jarso,72,25,39,136
Hedar,3rd,2010,Oromia,South West Shewa,Kersana Malima,1,99,65,165
Hamle,11th,2010,Oromia,West Arsi,Wondo,91,93,42,226
Megabit,7th,2010,Oromia,Horo Gudru Wellega,Abay Chomen,47,61,84,192
Ginbot,9th,2011,Oromia,Bale,Arena Buluq,15,89,87,191
Teqemt,2nd,2011,Oromia,Arsi,Digeluna Tijo,1,96,97,194
Miyazia,8th,2010,Oromia,Guji,Bore,74,36,12,122
Teqemt,2nd,2010,Oromia,West Shewa,Liban Jawi,47,83,74,204
Ginbot,9th,2010,Oromia,West Shewa,Adea Berga,66,58,93,217
Miyazia,8th,2011,Oromia,Arsi,Dodota,48,34,40,122
Teqemt,2nd,2011,Oromia,Borena,Yabelo,29,73,6,108
Hamle,11th,2009,Oromia,Horo Gudru Wellega,Amuru,24,9,66,99
Yekatit,6th,2009,Oromia,Borena,Guchi,40,66,90,196
Ginbot,9th,2010,Oromia,Arsi,Deksis,56,31,74,161
Ginbot,9th,2009,Oromia,Buno Bedele,Bedele Zuriya,43,70,80,193
Hedar,3rd,2011,Oromia,West Shewa,Jeldu,46,13,85,144
Ginbot,9th,2010,Oromia,Bale,Ginir,15,59,0,74
Yekatit,6th,2009,Oromia,South West Shewa,Tole,15,47,12,74
Miyazia,8th,2011,Oromia,East Wellega,Limu,1,35,83,119
Teqemt,2nd,2010,Oromia,Jimma,B/Tolyi,43,67,44,154
Teqemt,2nd,2011,Oromia,East Wellega,Kiremu,89,69,48,206
Hamle,11th,2009,Oromia,West Shewa,Ejerie,16,30,11,57
Megabit,7th,2009,Oromia,Borena,Dhas,87,93,9,189
Nehase,12th,2010,Oromia,West Shewa,Gojo Hospital,5,77,1,83
Hamle,11th,2009,Oromia,West Shewa,Gojo Hospital,45,49,79,173
Tahesas,4th,2011,Oromia,Finfine Zuria,Sandefa,65,20,98,183
Nehase,12th,2010,Oromia,West Guji,Hanbala,3,56,34,93
Ginbot,9th,2011,Oromia,Finfine Zuria,Sululta Town,12,72,28,112
Tahesas,4th,2011,Oromia,South West Shewa,Goro,72,49,45,166
Ginbot,9th,2010,Oromia,East Hararge,Goro Gutu,83,53,52,188
Sene,10th,2009,Oromia,West Wellega,Mendi Town,42,81,97,220
Yekatit,6th,2011,Oromia,West Shewa,Ilu Galan,31,93,52,176
Yekatit,6th,2009,Oromia,East Hararge,Kumbi,94,79,34,207
Miyazia,8th,2011,Oromia,Shashamane Town,Shashamane Town,11,77,81,169
Teqemt,2nd,2011,Oromia,Horo Gudru Wellega,Jarte Jardga,84,3,24,111
Ginbot,9th,2010,Oromia,East Hararge,Deder Hospital,94,45,66,205
Ginbot,9th,2011,Oromia,Arsi,Robe,66,49,97,212
Megabit,7th,2010,Oromia,Jimma,Dedo,49,28,63,140
Miyazia,8th,2009,Oromia,Borena,Yabelo Hospital,4,62,50,116
Tahesas,4th,2010,Oromia,West Guji,Bule Hora Toun,77,89,17,183
Meskerem,1st,2011,Oromia,Buno Bedele,Diga,84,53,30,167
Tir,5th,2009,Oromia,East Wellega,Haro Limu,52,37,41,130
Hedar,3rd,2011,Oromia,East Hararge,Melka Belo,77,91,80,248
Miyazia,8th,2010,Oromia,Arsi,Merti,82,58,80,220
Megabit,7th,2010,Oromia,Qeleme Wellega,Laloqile,37,80,45,162
Nehase,12th,2010,Oromia,East Shewa,Adami Tulu Jido Kombolcha,49,13,82,144
Teqemt,2nd,2010,Oromia,Bale,Agarfa,57,55,65,177
Tahesas,4th,2010,Oromia,Jimma,Mancho,52,12,30,94
Tir,5th,2010,Oromia,East Hararge,Haromaya Rural,59,63,41,163
Megabit,7th,2011,Oromia,Qeleme Wellega,Seyo,17,77,70,164
Tir,5th,2010,Oromia,Ilu Aba Bora,Algesachi,92,90,58,240
Meskerem,1st,2010,Oromia,East Shewa,Dugda,84,66,59,209
Miyazia,8th,2009,Oromia,East Wellega,Wayu Tuqa,61,20,76,157
Yekatit,6th,2009,Oromia,East Wellega,Diga,78,47,45,170
Ginbot,9th,2009,Oromia,West Guji,Bule Hora Hospital,38,59,43,140
Miyazia,8th,2011,Oromia,Bale,Gololcha,56,16,43,115
Sene,10th,2009,Oromia,Finfine Zuria,Berreh,48,14,10,72
Yekatit,6th,2010,Oromia,Holeta Town,Holeta Town,74,68,60,202
Hedar,3rd,2010,Oromia,Arsi,Dodota,41,85,76,202
Ginbot,9th,2011,Oromia,West Wellega,Qiltu Kara,33,44,14,91
Sene,10th,2011,Oromia,Borena,Arero,27,35,96,158
Miyazia,8th,2009,Oromia,East Wellega,Jimma Arjo,3,98,15,116
Teqemt,2nd,2010,Oromia,East Hararge,Garemuleta Hospital,23,7,27,57
Megabit,7th,2010,Oromia,Bale,Goba Town,84,74,91,249
Megabit,7th,2011,Oromia,West Shewa,Ejersa Lafo,34,57,16,107
Hedar,3rd,2010,Oromia,North Shewa,Abichugna,13,1,5,19
Sene,10th,2011,Oromia,Jimma,Gomma,86,2,49,137
Megabit,7th,2011,Oromia,West Hararge,Doba,30,5,31,66
Ginbot,9th,2009,Oromia,West Guji,Mkelka Soda,39,52,3,94
Nehase,12th,2010,Oromia,West Arsi,Dodola Town,83,77,68,228
Tir,5th,2009,Oromia,Assela Town,Assela Town,47,91,33,171
Tir,5th,2010,Oromia,West Wellega,Genji,7,6,22,35
Yekatit,6th,2009,Oromia,Nekemte Town,Nekemte Town,22,54,26,102
Tir,5th,2011,Oromia,Qeleme Wellega,Gawo Qebe,88,51,14,153
Megabit,7th,2011,Oromia,West Hararge,Bedesa Town,48,13,19,80
Megabit,7th,2011,Oromia,Horo Gudru Wellega,Jarte Jardga,89,33,68,190
Nehase,12th,2010,Oromia,Ilu Aba Bora,Bure,42,49,1,92
Tahesas,4th,2010,Oromia,Arsi,Deksis,14,98,62,174
Yekatit,6th,2009,Oromia,Guji,Bore,53,34,87,174
Tahesas,4th,2010,Oromia,Ilu Aba Bora,Algesachi,12,76,83,171
Hamle,11th,2010,Oromia,East Wellega,Boneya Bushe,71,69,11,151
Hedar,3rd,2010,Oromia,East Wellega,Nunu Qumba,66,93,3,162
Tir,5th,2009,Oromia,East Hararge,Meta,9,26,48,83
Tir,5th,2010,Oromia,Lege Dadi Lege Tafo Town,Lege Dadi Lege Tafo Town,52,65,14,131
Tir,5th,2010,Oromia,East Wellega,Jimma Arjo,75,2,93,170
Miyazia,8th,2010,Oromia,Bale,Berbere,89,20,21,130
Miyazia,8th,2009,Oromia,West Wellega,Gimbi,7,2,45,54
Yekatit,6th,2011,Oromia,Arsi,Ludehetosa,72,3,37,112
Teqemt,2nd,2010,Oromia,Guji,Adola Town,25,4,50,79
Yekatit,6th,2010,Oromia,Qeleme Wellega,Seyo,80,84,66,230
Tahesas,4th,2010,Oromia,West Hararge,Gelemso Hospital,42,46,48,136
Teqemt,2nd,2011,Oromia,East Hararge,Deder Hospital,88,39,61,188
Miyazia,8th,2011,Oromia,Sebeta Town,Sebeta Town,34,2,40,76
Hamle,11th,2009,Oromia,East Hararge,Aweday Town,47,10,5,62
Sene,10th,2009,Oromia,Bale,Arena Buluq,67,58,89,214
Ginbot,9th,2011,Oromia,West Arsi,Arsi Negele Town,17,69,69,155
Yekatit,6th,2010,Oromia,Jimma,Limu Hospital,81,20,32,133
Megabit,7th,2011,Oromia,West Shewa,Metarobi,30,84,93,207
Nehase,12th,2010,Oromia,West Guji,Dugda Dawa,5,47,0,52
Ginbot,9th,2009,Oromia,West Shewa,Ejerie,88,13,82,183
Nehase,12th,2009,Oromia,Finfine Zuria,Akaki,23,58,87,168
Miyazia,8th,2010,Oromia,Arsi,Shenan Kolu,3,83,33,119
Miyazia,8th,2010,Oromia,Jimma,O/Beyam,64,48,58,170
Ginbot,9th,2010,Oromia,West Wellega,Jarso,26,48,42,116
Teqemt,2nd,2010,Oromia,Qeleme Wellega,Sedan Chanka,52,10,68,130
Tahesas,4th,2010,Oromia,East Shewa,Fentale,84,31,6,121
Ginbot,9th,2010,Oromia,Qeleme Wellega,Dale Wabera,22,89,99,210
Miyazia,8th,2009,Oromia,Burayu Town,Burayu Town,30,57,75,162
Ginbot,9th,2009,Oromia,West Shewa,Elifata,51,56,27,134
Miyazia,8th,2009,Oromia,Borena,Yabelo,14,83,66,163
Megabit,7th,2009,Oromia,North Shewa,Aleiltu,31,59,86,176
Hedar,3rd,2010,Oromia,East Wellega,Sibu Sire,20,68,37,125
Nehase,12th,2010,Oromia,East Hararge,Haromaya Town,62,76,44,182
Tahesas,4th,2010,Oromia,Burayu Town,Burayu Town,27,65,69,161
Tir,5th,2010,Oromia,North Shewa,Debre Libanos,7,75,10,92
Yekatit,6th,2010,Oromia,South West Shewa,Wonchi,30,53,6,89
Ginbot,9th,2010,Oromia,West Shewa,Liban Jawi,98,14,24,136
Hamle,11th,2010,Oromia,Jimma,Limu Kosa,96,6,10,112
Hedar,3rd,2011,Oromia,West Arsi,Siraro,84,15,31,130
Teqemt,2nd,2010,Oromia,Horo Gudru Wellega,Chomen Guduru,88,46,12,146
Hedar,3rd,2010,Oromia,West Wellega,Gimbi Rural,85,25,25,135
Tahesas,4th,2011,Oromia,West Arsi,Hebal Arsi,14,29,88,131
Ginbot,9th,2009,Oromia,Shashamane Town,Shashamane Town,52,0,61,113
Hedar,3rd,2010,Oromia,West Wellega,Gimbi,66,17,41,124
Yekatit,6th,2009,Oromia,Buno Bedele,Bedele Town,98,93,50,241
Meskerem,1st,2010,Oromia,West Arsi,Gedeb Asasa,39,84,42,165
Hamle,11th,2009,Oromia,East Hararge,Haromaya Rural,22,70,50,142
Hedar,3rd,2010,Oromia,Borena,Meyo,2,54,73,129
Nehase,12th,2009,Oromia,Horo Gudru Wellega,Amuru,46,20,3,69
Meskerem,1st,2010,Oromia,Arsi,Limuna Bilbilo,87,53,80,220
Sene,10th,2009,Oromia,Arsi,Chole,97,94,49,240
Ginbot,9th,2011,Oromia,Jimma,Chora Boter,10,89,33,132
Tir,5th,2009,Oromia,West Shewa,Tikur Enchini,48,74,79,201
Hedar,3rd,2010,Oromia,East Hararge,Haromaya Hospital,40,34,11,85
Yekatit,6th,2010,Oromia,East Hararge,Meta,97,63,12,172
Hedar,3rd,2010,Oromia,East Wellega,Wayu Tuqa,85,10,7,102
Ginbot,9th,2011,Oromia,Bale,Legehida,63,51,4,118
Teqemt,2nd,2011,Oromia,West Wellega,Gimbi,73,69,60,202
Megabit,7th,2010,Oromia,Qeleme Wellega,Hawa Gelan,98,39,89,226
Meskerem,1st,2010,Oromia,West Hararge,Habro,70,70,89,229
Tir,5th,2010,Oromia,West Guji,Bule Hora Toun,66,43,67,176
Megabit,7th,2010,Oromia,West Hararge,Chiro Hospital,61,12,79,152
Ginbot,9th,2009,Oromia,West Shewa,Chelia,40,5,35,80
Hamle,11th,2010,Oromia,West Shewa,Nono,54,17,65,136
Tir,5th,2011,Oromia,West Arsi,Wondo,87,76,56,219
Teqemt,2nd,2011,Oromia,Arsi,Robe,86,67,85,238
Sene,10th,2010,Oromia,Horo Gudru Wellega,Jima Rare,20,17,44,81
Sene,10th,2010,Oromia,Borena,Dhas,3,56,81,140
Meskerem,1st,2011,Oromia,Buno Bedele,Meko,68,99,49,216
Tahesas,4th,2011,Oromia,Arsi,Munesa,43,7,31,81
Tir,5th,2010,Oromia,Assela Town,Assela Town,50,57,23,130
Tir,5th,2011,Oromia,West Wellega,Nejo Town,71,15,26,112
Sene,10th,2009,Oromia,Jimma,Mana,84,43,34,161
Hamle,11th,2009,Oromia,Bale,Ginir,31,49,41,121
Hedar,3rd,2011,Oromia,Jimma,Sekoru,47,7,17,71
Hamle,11th,2009,Oromia,East Wellega,Jimma Arjo,52,5,49,106
Sene,10th,2009,Oromia,West Shewa,Ambo Hospital,93,13,93,199
Miyazia,8th,2009,Oromia,Borena,Dire,4,42,11,57
Yekatit,6th,2010,Oromia,Bale,Legehida,65,60,77,202
Tir,5th,2010,Oromia,Arsi,Ludehetosa,12,45,17,74
Hedar,3rd,2011,Oromia,Arsi,Ludehetosa,63,12,46,121
Miyazia,8th,2010,Oromia,West Guji,Bule Hora Toun,47,93,29,169
Ginbot,9th,2011,Oromia,West Shewa,Tibe Kutaye,79,20,93,192
Sene,10th,2011,Oromia,Bale,Goro,95,50,94,239
Sene,10th,2010,Oromia,Sebeta Town,Sebeta Town,19,81,9,109
Megabit,7th,2010,Oromia,North Shewa,Debre Libanos,24,50,99,173
Teqemt,2nd,2010,Oromia,Bale,Raitu,94,90,0,184
Nehase,12th,2009,Oromia,Jimma,O/Beyam,30,57,0,87
Nehase,12th,2009,Oromia,Arsi,Jeju,70,71,96,237
Nehase,12th,2009,Oromia,West Guji,Abaya,55,56,91,202
Miyazia,8th,2011,Oromia,West Shewa,Inchini Hospital,59,22,61,142
Hedar,3rd,2010,Oromia,West Shewa,Dendi,29,26,89,144
Tir,5th,2011,Oromia,Arsi,Chole,45,62,98,205
Ginbot,9th,2011,Oromia,East Hararge,Jarso,41,59,92,192
Hamle,11th,2009,Oromia,West Wellega,Mene Sibu,14,61,27,102
Sene,10th,2010,Oromia,Jimma,Dedo,40,48,65,153
Miyazia,8th,2010,Oromia,East Wellega,Kiremu,87,94,17,198
Hamle,11th,2010,Oromia,Guji,Wadara,42,87,76,205
Hamle,11th,2010,Oromia,East Wellega,Gobu Seyo,1,83,35,119
Nehase,12th,2009,Oromia,West Hararge,West Harerge	Gumbi Bordede,9,59,65,133
Hamle,11th,2010,Oromia,Ilu Aba Bora,Yayu,93,77,91,261
Teqemt,2nd,2011,Oromia,East Wellega,Sasiga,59,24,20,103
Sene,10th,2009,Oromia,West Wellega,Begi,20,76,39,135
Ginbot,9th,2011,Oromia,Guji,Anna Sora,45,9,47,101
Meskerem,1st,2011,Oromia,North Shewa,Girar Jarso,10,29,81,120
Megabit,7th,2010,Oromia,East Wellega,Leqa Dulecha,2,52,96,150
Yekatit,6th,2009,Oromia,East Wellega,Wayu Tuqa,62,25,64,151
Megabit,7th,2010,Oromia,Robe Town,Robe Town,95,16,71,182
Sene,10th,2011,Oromia,Jimma,Limu Kosa,68,86,45,199
Ginbot,9th,2010,Oromia,North Shewa,Yaya Gulele,61,48,50,159
Nehase,12th,2009,Oromia,East Hararge,Haromaya Hospital,23,92,23,138
Miyazia,8th,2009,Oromia,Borena,Guchi,77,66,10,153
Megabit,7th,2010,Oromia,Borena,El Way,80,58,30,168
Hamle,11th,2009,Oromia,Ilu Aba Bora,Algesachi,97,35,35,167
Sene,10th,2011,Oromia,West Shewa,Ejerie,47,80,38,165
Sene,10th,2010,Oromia,East Wellega,Nunu Qumba,47,27,71,145
Sene,10th,2010,Oromia,West Guji,Bule Hora Hospital,21,98,15,134
Nehase,12th,2009,Oromia,West Hararge,Doba,15,20,86,121
Hedar,3rd,2010,Oromia,Borena,Arero,89,93,47,229
Teqemt,2nd,2010,Oromia,Ilu Aba Bora,Didu,21,97,75,193
Teqemt,2nd,2010,Oromia,West Shewa,Gedo Hospital,47,84,72,203
Nehase,12th,2009,Oromia,West Shewa,Ejersa Lafo,5,8,52,65
Ginbot,9th,2010,Oromia,West Shewa,Guder Hosp,87,52,60,199
Tahesas,4th,2010,Oromia,East Wellega,Haro Limu,97,80,8,185
Nehase,12th,2010,Oromia,East Shewa,Fentale,43,16,46,105
Ginbot,9th,2009,Oromia,West Hararge,Burka Dimtu,51,7,49,107
Tahesas,4th,2011,Oromia,Buno Bedele,Meko,20,11,44,75
Teqemt,2nd,2011,Oromia,South West Shewa,Kersana Malima,57,86,67,210
Yekatit,6th,2011,Oromia,East Wellega,Sibu Sire,49,39,71,159
Tahesas,4th,2011,Oromia,Ilu Aba Bora,Hurumu,39,13,86,138
Nehase,12th,2010,Oromia,Qeleme Wellega,Seyo,75,16,65,156
Nehase,12th,2010,Oromia,East Shewa,Liben,83,55,93,231
Nehase,12th,2009,Oromia,West Wellega,Begi,57,50,6,113
Miyazia,8th,2010,Oromia,East Wellega,Wama Hagelo,66,87,67,220
Teqemt,2nd,2010,Oromia,East Shewa,Boset,11,48,81,140
Nehase,12th,2010,Oromia,East Hararge,Bedeno,19,64,20,103
Tir,5th,2011,Oromia,West Wellega,Haru,8,73,3,84
Ginbot,9th,2009,Oromia,East Wellega,Boneya Bushe,48,7,5,60
Ginbot,9th,2011,Oromia,West Wellega,Gimbi Public  Hospital,6,88,71,165
Teqemt,2nd,2011,Oromia,West Shewa,Gindeberet Hospital,87,58,72,217
Teqemt,2nd,2011,Oromia,Finfine Zuria,Berreh,56,71,22,149
Sene,10th,2009,Oromia,South West Shewa,Tulu Bolo Hospital,50,73,74,197
Hamle,11th,2010,Oromia,Borena,Arero,45,81,24,150
Tir,5th,2010,Oromia,East Shewa,Adea,63,55,10,128
Miyazia,8th,2011,Oromia,West Shewa,Nono,27,1,27,55
Hamle,11th,2010,Oromia,West Shewa,Meta Waliqite,73,95,65,233
Sene,10th,2011,Oromia,Bale,Sinana,7,3,3,13
Teqemt,2nd,2011,Oromia,West Arsi,Gedeb Asasa,1,78,49,128
Meskerem,1st,2010,Oromia,Ilu Aba Bora,Algesachi,47,24,49,120
Teqemt,2nd,2011,Oromia,East Shewa,Olanciti Hospital,54,15,48,117
Teqemt,2nd,2010,Oromia,North Shewa,Yaya Gulele,47,6,5,58
Hamle,11th,2010,Oromia,North Shewa,Dera,89,16,86,191
Ginbot,9th,2009,Oromia,Horo Gudru Wellega,Hababo Guduru,41,95,41,177
Teqemt,2nd,2010,Oromia,Bale,Goba Town,48,63,14,125
Sene,10th,2009,Oromia,Bale,Goba Town,25,79,45,149
Nehase,12th,2009,Oromia,Bale,Seweyna,65,81,54,200
Nehase,12th,2009,Oromia,Guji,Saba Boru,77,67,55,199
Sene,10th,2010,Oromia,Ilu Aba Bora,Nono Sele,88,95,90,273
Meskerem,1st,2010,Oromia,West Shewa,Inchini Hospital,53,14,92,159
Miyazia,8th,2011,Oromia,Jimma,O/Beyam,4,40,14,58
Teqemt,2nd,2010,Oromia,West Hararge,Burka Dimtu,85,39,99,223
Meskerem,1st,2010,Oromia,Bale,Meda Welabu,95,67,12,174
Tir,5th,2011,Oromia,Buno Bedele,Dapho Hana,60,11,87,158
Tir,5th,2011,Oromia,Finfine Zuria,Akaki,46,83,29,158
Miyazia,8th,2011,Oromia,Jimma,Kersa,29,38,5,72
Teqemt,2nd,2010,Oromia,Horo Gudru Wellega,Jima Rare,75,0,49,124
Megabit,7th,2010,Oromia,North Shewa,Wuchale,93,16,24,133
Tir,5th,2009,Oromia,West Wellega,Nole Kaba,43,97,4,144
Tahesas,4th,2010,Oromia,South West Shewa,St.Luke Hospital,85,68,70,223
Hedar,3rd,2010,Oromia,Guji,Aga Wayyu,23,12,93,128
Ginbot,9th,2011,Oromia,West Hararge,Mesela,3,25,37,65
Miyazia,8th,2010,Oromia,Bale,Dawe Serar,28,51,20,99
Ginbot,9th,2011,Oromia,South West Shewa,Ameya Hospital,87,23,8,118
Yekatit,6th,2011,Oromia,East Hararge,Babile Woreda,41,46,87,174
Tir,5th,2011,Oromia,East Wellega,Haro Limu,25,89,60,174
Meskerem,1st,2010,Oromia,Gelan Town,Gelan Town,8,2,9,19
Tir,5th,2010,Oromia,Horo Gudru Wellega,Jima Geneti,1,82,89,172
Megabit,7th,2011,Oromia,North Shewa,Girar Jarso,1,61,55,117
Yekatit,6th,2010,Oromia,West Hararge,Daro Lebu,31,84,48,163
Miyazia,8th,2011,Oromia,Burayu Town,Burayu Town,40,98,20,158
Meskerem,1st,2011,Oromia,West Wellega,Mendi Hospital,4,76,17,97
Miyazia,8th,2011,Oromia,Arsi,Aseko,64,5,55,124
Meskerem,1st,2011,Oromia,Guji,Negele Hospital,20,65,80,165
Meskerem,1st,2010,Oromia,West Wellega,Mendi Hospital,79,4,80,163
Yekatit,6th,2010,Oromia,North Shewa,Girar Jarso,85,11,28,124
Tahesas,4th,2010,Oromia,East Shewa,Liben,95,51,75,221
Sene,10th,2011,Oromia,East Shewa,Boset,72,33,38,143
Sene,10th,2009,Oromia,East Hararge,Kersa Eh,98,98,2,198
Yekatit,6th,2010,Oromia,West Wellega,Nejo Rural,39,54,26,119
Ginbot,9th,2010,Oromia,Finfine Zuria,Berreh,41,62,44,147
Ginbot,9th,2011,Oromia,Qeleme Wellega,Gidami,34,18,39,91
Miyazia,8th,2010,Oromia,West Arsi,Kore,42,38,24,104
Hamle,11th,2010,Oromia,East Shewa,Fentale,34,72,94,200
Megabit,7th,2011,Oromia,East Hararge,Chinakesen,19,85,71,175
Nehase,12th,2010,Oromia,Ilu Aba Bora,Bure,58,66,30,154
Miyazia,8th,2011,Oromia,Guji,Odo Shakiso,24,95,52,171
Teqemt,2nd,2011,Oromia,Horo Gudru Wellega,Gudru,51,59,7,117
Hedar,3rd,2011,Oromia,Bale,Gololcha,13,80,26,119
Megabit,7th,2009,Oromia,East Shewa,Adea,2,84,36,122
Megabit,7th,2010,Oromia,Borena,Dilo,59,77,22,158
Nehase,12th,2010,Oromia,West Wellega,Lata Sibu,10,85,77,172
Hamle,11th,2010,Oromia,East Wellega,Gida Ayana,34,57,89,180
Hamle,11th,2009,Oromia,West Hararge,Chiro Town,26,38,73,137
Tir,5th,2011,Oromia,Borena,Dire,47,91,56,194
Sene,10th,2009,Oromia,Guji,Adola Reda,99,69,36,204
Tir,5th,2010,Oromia,West Wellega,Begi Hospital,87,56,89,232
Yekatit,6th,2009,Oromia,Burayu Town,Burayu Town,90,3,94,187
Hamle,11th,2009,Oromia,Jimma,O/Beyam,9,56,17,82
Megabit,7th,2010,Oromia,Ilu Aba Bora,Yayu,93,92,22,207
Miyazia,8th,2009,Oromia,West Wellega,Nejo Rural,3,0,1,4
Meskerem,1st,2011,Oromia,Jimma,Mana,88,39,26,153
Tir,5th,2011,Oromia,West Wellega,Guliso,17,6,15,38
Sene,10th,2011,Oromia,North Shewa,Wuchale,18,54,46,118
Tir,5th,2010,Oromia,Buno Bedele,Bedele Hospital,49,90,79,218
Hamle,11th,2009,Oromia,Adama Special Town,Adama Town,58,54,20,132
Miyazia,8th,2009,Oromia,Ilu Aba Bora,Bure,30,90,86,206
Nehase,12th,2010,Oromia,Jimma,Guma,90,25,5,120
Teqemt,2nd,2011,Oromia,South West Shewa,Seden Sodo,42,15,83,140
Teqemt,2nd,2011,Oromia,Guji,Aga Wayyu,24,87,8,119
Ginbot,9th,2011,Oromia,East Hararge,Kurfa Chele,40,4,25,69
Megabit,7th,2011,Oromia,West Hararge,Oda Bultum,89,70,50,209
Tahesas,4th,2010,Oromia,Jimma,B/Tolyi,21,43,74,138
Sene,10th,2010,Oromia,Arsi,Guna,5,52,63,120
Tir,5th,2011,Oromia,East Shewa,Boset,32,7,85,124
Ginbot,9th,2011,Oromia,Buno Bedele,Bedele Town,3,93,82,178
Miyazia,8th,2011,Oromia,East Shewa,Lomme,49,54,79,182
Yekatit,6th,2009,Oromia,Arsi,Shenan Kolu,76,62,13,151
Miyazia,8th,2009,Oromia,East Wellega,Wama Hagelo,78,16,15,109
Sene,10th,2010,Oromia,Bale,Legehida,37,74,23,134
Hamle,11th,2010,Oromia,Nekemte Town,Nekemte Town,30,26,33,89
Hedar,3rd,2011,Oromia,North Shewa,Degem,61,71,34,166
Nehase,12th,2010,Oromia,Borena,Meyo,54,46,28,128
Yekatit,6th,2009,Oromia,Sebeta Town,Sebeta Town,21,62,8,91
Yekatit,6th,2011,Oromia,Finfine Zuria,Walmera,61,65,32,158
Megabit,7th,2009,Oromia,West Hararge,Bedesa Town,89,28,60,177
Nehase,12th,2009,Oromia,Arsi,Robe,76,89,72,237
Yekatit,6th,2011,Oromia,West Guji,Kercha,96,54,17,167
Hedar,3rd,2010,Oromia,North Shewa,Were Jarso,53,80,4,137
Meskerem,1st,2010,Oromia,Bale,Delo Mena,58,75,31,164
Sene,10th,2011,Oromia,West Wellega,Qiltu Kara,62,26,79,167
Hedar,3rd,2011,Oromia,West Wellega,Mene Sibu,66,3,51,120
Miyazia,8th,2010,Oromia,East Wellega,Wama Hagelo,72,64,98,234
Nehase,12th,2010,Oromia,North Shewa,Girar Jarso,78,93,40,211
Sene,10th,2011,Oromia,East Wellega,Sibu Sire,23,66,57,146
Tir,5th,2010,Oromia,Ilu Aba Bora,Hurumu,68,38,76,182
Sene,10th,2011,Oromia,East Hararge,Goro Muti,30,33,57,120
Tir,5th,2011,Oromia,Bale,Goba Town,25,91,53,169
Tir,5th,2011,Oromia,West Wellega,Gimbi,20,91,29,140
Nehase,12th,2010,Oromia,Guji,Adola Hospital,62,27,8,97
Teqemt,2nd,2010,Oromia,North Shewa,Kuyu,19,12,62,93
Hedar,3rd,2011,Oromia,West Wellega,Gimbi Public  Hospital,3,68,95,166
Hedar,3rd,2011,Oromia,West Hararge,Oda Bultum,15,52,5,72
Miyazia,8th,2011,Oromia,Bale,Gasera,75,91,11,177
Ginbot,9th,2010,Oromia,West Hararge,Anchar,10,77,89,176
Tahesas,4th,2011,Oromia,North Shewa,Girar Jarso,7,13,81,101
Sene,10th,2010,Oromia,East Shewa,Adama,97,76,30,203
Teqemt,2nd,2011,Oromia,East Hararge,Kombolicha,17,58,9,84
Yekatit,6th,2011,Oromia,Jimma,Seka Chhokorsa Hospital,16,16,71,103
Tahesas,4th,2010,Oromia,West Hararge,Burka Dimtu,59,13,39,111
Miyazia,8th,2009,Oromia,Horo Gudru Wellega,Jima Rare,77,90,51,218
Yekatit,6th,2010,Oromia,Finfine Zuria,Sebeta Awas,8,27,26,61
Megabit,7th,2010,Oromia,Qeleme Wellega,Yemalogi Wolel,26,39,22,87
Tahesas,4th,2010,Oromia,West Hararge,Mesela,94,32,16,142
Ginbot,9th,2011,Oromia,Arsi,Hitosa,1,80,48,129
Tir,5th,2011,Oromia,Nekemte Town,Nekemte Town,38,75,20,133
Tahesas,4th,2010,Oromia,West Guji,Bule Hora,29,67,80,176
Nehase,12th,2009,Oromia,Horo Gudru Wellega,Abe Dengoro,12,97,85,194
Tahesas,4th,2011,Oromia,East Wellega,Jimma Arjo,30,85,50,165
Ginbot,9th,2009,Oromia,West Wellega,Nejo Hospital,93,19,86,198
Megabit,7th,2010,Oromia,West Wellega,Begi,12,8,15,35
Tir,5th,2011,Oromia,Jimma,Shabe,63,7,56,126
Nehase,12th,2010,Oromia,North Shewa,Dera,63,55,30,148
Yekatit,6th,2010,Oromia,Jimma,Limu Hospital,24,35,23,82
Meskerem,1st,2011,Oromia,Jimma,Dedo,28,28,18,74
Meskerem,1st,2011,Oromia,West Guji,Biebirsa Kojowa,64,97,25,186
Hamle,11th,2009,Oromia,Finfine Zuria,Mullo,63,9,83,155
Teqemt,2nd,2010,Oromia,West Arsi,Shashemene Rural,5,83,60,148
Tir,5th,2010,Oromia,Borena,Gomole,90,63,5,158
Tahesas,4th,2011,Oromia,Arsi,Seru,95,31,84,210
Teqemt,2nd,2010,Oromia,Arsi,Robe,67,67,29,163
Teqemt,2nd,2011,Oromia,Horo Gudru Wellega,Jima Geneti,58,7,40,105
Hedar,3rd,2011,Oromia,Arsi,Tiyo,3,64,8,75
Tir,5th,2011,Oromia,East Shewa,Lomme,69,11,24,104
Hedar,3rd,2010,Oromia,East Wellega,Gida Ayana,14,41,53,108
Teqemt,2nd,2011,Oromia,Modjo Town,Modjo Town,77,4,16,97
Miyazia,8th,2009,Oromia,West Hararge,Doba,1,78,59,138
Hedar,3rd,2011,Oromia,East Wellega,Diga,88,12,59,159
Hamle,11th,2009,Oromia,Borena,Yabelo,88,55,55,198
Ginbot,9th,2010,Oromia,Buno Bedele,Boricha,12,2,8,22
Sene,10th,2009,Oromia,East Hararge,Meyu Muleke,26,71,4,101
Miyazia,8th,2011,Oromia,Jimma,Guma,52,26,72,150
Miyazia,8th,2010,Oromia,West Wellega,Ayira Hospital,32,59,75,166
Tahesas,4th,2010,Oromia,West Guji,Dugda Dawa,47,10,51,108
Ginbot,9th,2010,Oromia,East Hararge,Girawa,21,94,42,157
Nehase,12th,2009,Oromia,Bale,Berbere,72,16,65,153
Tahesas,4th,2011,Oromia,Jimma,Sekoru,23,74,36,133
Tahesas,4th,2010,Oromia,Sebeta Town,Sebeta Town,12,6,62,80
Miyazia,8th,2011,Oromia,Lege Dadi Lege Tafo Town,Lege Dadi Lege Tafo Town,1,16,40,57
Nehase,12th,2010,Oromia,Bale,Gura Dhamole,31,72,66,169
Nehase,12th,2010,Oromia,East Hararge,Garemuleta Hospital,49,98,83,230
Megabit,7th,2010,Oromia,West Arsi,Nensebo,2,47,62,111
Megabit,7th,2010,Oromia,West Arsi,Gambo Hospital,88,79,71,238
Megabit,7th,2010,Oromia,East Wellega,Wama Hagelo,71,85,62,218
Miyazia,8th,2010,Oromia,Sebeta Town,Sebeta Town,5,68,53,126
Hamle,11th,2010,Oromia,West Wellega,Ayira,67,53,53,173
Meskerem,1st,2010,Oromia,East Shewa,Gimbichu,79,84,48,211
Hamle,11th,2009,Oromia,Finfine Zuria,Holeta,66,99,76,241
Miyazia,8th,2009,Oromia,Qeleme Wellega,Dale Wabera,17,2,51,70
Megabit,7th,2009,Oromia,Guji,Girja,63,73,47,183
Megabit,7th,2011,Oromia,East Shewa,Fentale,49,12,52,113
Megabit,7th,2011,Oromia,West Shewa,Gedo Hospital,8,49,40,97
Ginbot,9th,2010,Oromia,Horo Gudru Wellega,Amuru,26,91,48,165
Tahesas,4th,2010,Oromia,Borena,Dilo,57,92,52,201
Megabit,7th,2009,Oromia,West Wellega,Ayira Hospital,24,68,69,161
Meskerem,1st,2011,Oromia,North Shewa,Kuyu,52,46,34,132
Teqemt,2nd,2010,Oromia,West Guji,Dugda Dawa,84,46,82,212
Megabit,7th,2011,Oromia,North Shewa,Debre Libanos,76,11,86,173
Megabit,7th,2009,Oromia,East Hararge,Deder,91,85,40,216
Megabit,7th,2011,Oromia,West Arsi,Kokosa  Hospital,17,53,76,146
Miyazia,8th,2010,Oromia,West Hararge,West Harerge	Gumbi Bordede,53,48,24,125
Hamle,11th,2010,Oromia,South West Shewa,Ameya Hospital,75,0,45,120
Miyazia,8th,2010,Oromia,Arsi,Shirka,26,45,34,105
Ginbot,9th,2009,Oromia,Horo Gudru Wellega,Shambu Town,94,64,95,253
Miyazia,8th,2009,Oromia,Horo Gudru Wellega,Shambu Town,7,51,48,106
Meskerem,1st,2011,Oromia,West Wellega,Qiltu Kara,0,93,61,154
Teqemt,2nd,2011,Oromia,Horo Gudru Wellega,Shambu Town,67,66,22,155
Hedar,3rd,2011,Oromia,East Shewa,Adami Tulu Jido Kombolcha,51,5,78,134
Tahesas,4th,2011,Oromia,East Wellega,Guto Gida,8,28,0,36
Ginbot,9th,2010,Oromia,Arsi,Dodota,44,94,74,212
Miyazia,8th,2009,Oromia,Jimma,Gera,81,41,39,161
Miyazia,8th,2009,Oromia,Jimma,Guma,77,24,66,167
Ginbot,9th,2010,Oromia,North Shewa,Abichugna,25,87,18,130
Tahesas,4th,2011,Oromia,West Hararge,West Harerge	Gumbi Bordede,18,43,73,134
Miyazia,8th,2009,Oromia,East Hararge,Haromaya Rural,22,0,11,33
Sene,10th,2009,Oromia,Arsi,Shirka,93,91,33,217
Ginbot,9th,2011,Oromia,West Arsi,Arsi Negele Rural,83,64,1,148
Ginbot,9th,2009,Oromia,North Shewa,Aleiltu,89,72,82,243
Sene,10th,2011,Oromia,Bale,Seweyna,0,40,58,98
Yekatit,6th,2011,Oromia,East Hararge,Haromaya Rural,51,91,45,187
Teqemt,2nd,2010,Oromia,South West Shewa,Sodo Dac'Ha,95,91,76,262
Tir,5th,2011,Oromia,West Shewa,Inchini Hospital,3,15,88,106
Miyazia,8th,2009,Oromia,West Shewa,Codi,1,43,30,74
Teqemt,2nd,2010,Oromia,Borena,Teltele,44,7,15,66
Sene,10th,2011,Oromia,Borena,Gomole,35,77,90,202
Miyazia,8th,2011,Oromia,West Shewa,Chelia,89,23,79,191
Megabit,7th,2011,Oromia,Shashamane Town,Shashamane Town,66,60,20,146
Hamle,11th,2010,Oromia,Bale,Sinana,14,99,74,187
Meskerem,1st,2011,Oromia,Gelan Town,Gelan Town,9,12,83,104
Megabit,7th,2009,Oromia,East Shewa,Gimbichu,56,6,1,63
Megabit,7th,2009,Oromia,West Shewa,Adea Berga,36,89,6,131
Tir,5th,2009,Oromia,West Arsi,Kofele,74,37,29,140
Ginbot,9th,2009,Oromia,West Shewa,Midakegni,89,98,2,189
Teqemt,2nd,2010,Oromia,Buno Bedele,Dapho Hana,15,71,74,160
Megabit,7th,2011,Oromia,East Shewa,Olanciti Hospital,22,2,6,30
Meskerem,1st,2011,Oromia,Finfine Zuria,Sandefa,90,47,44,181
Ginbot,9th,2009,Oromia,East Hararge,Girawa,71,57,70,198
Teqemt,2nd,2011,Oromia,Borena,Arero,44,30,58,132
Sene,10th,2009,Oromia,West Shewa,Chelia,66,97,56,219
Sene,10th,2010,Oromia,Jimma,Sigmo,49,37,64,150
Nehase,12th,2010,Oromia,Borena,Yabelo Rural,73,60,48,181
Sene,10th,2009,Oromia,West Wellega,Boji Cheqorsa,30,54,85,169
Nehase,12th,2009,Oromia,Borena,Meyo,12,3,81,96
Meskerem,1st,2010,Oromia,West Guji,Mkelka Soda,76,61,98,235
Megabit,7th,2009,Oromia,Finfine Zuria,Holeta,55,25,44,124
Tir,5th,2010,Oromia,West Wellega,Guliso,98,46,97,241
Teqemt,2nd,2011,Oromia,Qeleme Wellega,Yemalogi Wolel,47,72,49,168
Tir,5th,2011,Oromia,West Shewa,Bako Hospital,86,34,27,147
Tir,5th,2009,Oromia,West Guji,Bule Hora Hospital,27,19,17,63
Megabit,7th,2011,Oromia,Arsi,Deksis,48,29,6,83
Sene,10th,2011,Oromia,East Hararge,Midega Tole,88,28,16,132
Teqemt,2nd,2010,Oromia,Borena,Teltele,76,19,42,137
Hedar,3rd,2011,Oromia,North Shewa,Wuchale,5,57,27,89
Miyazia,8th,2009,Oromia,West Guji,Bule Hora,53,66,3,122
Megabit,7th,2011,Oromia,East Hararge,Girawa,76,22,26,124
Megabit,7th,2011,Oromia,Arsi,Limuna Bilbilo,49,32,43,124
Hamle,11th,2010,Oromia,Ilu Aba Bora,Yayu,61,13,5,79
Sene,10th,2009,Oromia,West Wellega,Boji Cheqorsa,50,49,69,168
Nehase,12th,2010,Oromia,East Wellega,Nunu Qumba,74,83,61,218
Ginbot,9th,2011,Oromia,East Wellega,Kiremu,42,59,0,101
Tir,5th,2010,Oromia,West Arsi,Gedeb Asasa,14,10,89,113
Teqemt,2nd,2011,Oromia,Jimma,Chora Boter,48,85,32,165
Hedar,3rd,2011,Oromia,East Shewa,Lomme,45,21,62,128
Nehase,12th,2009,Oromia,North Shewa,Abichugna,82,48,42,172
Hamle,11th,2009,Oromia,Qeleme Wellega,Anfilo,45,50,53,148
Miyazia,8th,2010,Oromia,Arsi,Bekoji Town,86,95,5,186
Megabit,7th,2011,Oromia,Arsi,Tiyo,14,3,96,113
Miyazia,8th,2011,Oromia,Finfine Zuria,Sululta Town,30,0,19,49
Tir,5th,2009,Oromia,East Hararge,Jarso,35,51,53,139
Nehase,12th,2010,Oromia,West Shewa,Tikur Enchini,60,67,67,194
Megabit,7th,2011,Oromia,Ilu Aba Bora,Doreni,51,5,56,112
Hedar,3rd,2011,Oromia,Buno Bedele,Bedele Zuriya,66,98,70,234
Ginbot,9th,2010,Oromia,Arsi,Tena,45,49,7,101
Ginbot,9th,2009,Oromia,Jimma,Limu Hospital,0,52,40,92
Ginbot,9th,2010,Oromia,Ilu Aba Bora,Metu Rural,63,35,6,104
Hedar,3rd,2010,Oromia,East Hararge,Goro Gutu,48,7,78,133
Hamle,11th,2009,Oromia,Guji,Adola Town,35,36,11,82
Nehase,12th,2009,Oromia,Guji,Aga Wayyu,56,12,53,121
Megabit,7th,2009,Oromia,Borena,Guchi,33,78,53,164
Megabit,7th,2010,Oromia,West Guji,Bule Hora,58,70,29,157
Hamle,11th,2010,Oromia,South West Shewa,Ameya Hospital,66,62,72,200
Teqemt,2nd,2011,Oromia,Bale,Gura Dhamole,75,26,82,183
Yekatit,6th,2009,Oromia,West Shewa,Abuna Gindeberet,87,10,1,98
Tir,5th,2009,Oromia,West Shewa,Midakegni,82,98,20,200
Ginbot,9th,2009,Oromia,Finfine Zuria,Sandefa,8,0,5,13
Hedar,3rd,2011,Oromia,West Wellega,Mene Sibu,61,45,2,108
Nehase,12th,2009,Oromia,Ilu Aba Bora,Nono Sele,83,58,95,236
Sene,10th,2010,Oromia,Bale,Goba Town,28,10,74,112
Sene,10th,2009,Oromia,Borena,Yabelo Rural,74,83,29,186
Sene,10th,2010,Oromia,Guji,Adola Reda,39,10,52,101
Teqemt,2nd,2011,Oromia,West Arsi,Dodola Town,29,46,5,80
Hamle,11th,2010,Oromia,West Hararge,Tulo,81,85,63,229
Ginbot,9th,2010,Oromia,Finfine Zuria,Sebeta Awas,97,62,74,233
Megabit,7th,2010,Oromia,East Wellega,Ebantu,12,13,89,114
Yekatit,6th,2011,Oromia,Finfine Zuria,Berreh,91,59,54,204
Teqemt,2nd,2011,Oromia,Jimma Spe Town,Jimma Spe Town,58,1,26,85
Megabit,7th,2010,Oromia,Jimma,Shabe,10,90,62,162
Hamle,11th,2010,Oromia,West Wellega,Seyo Nole,8,0,21,29
Miyazia,8th,2011,Oromia,West Wellega,Boji Dermeji,92,62,43,197
Miyazia,8th,2009,Oromia,West Guji,Bule Hora Hospital,27,54,0,81
Sene,10th,2011,Oromia,West Wellega,Lalo Asabi,42,18,3,63
Ginbot,9th,2011,Oromia,Borena,Moyale Hospital,27,62,49,138
Megabit,7th,2010,Oromia,Arsi,Bale Gesgara,66,4,20,90
Hedar,3rd,2011,Oromia,East Shewa,Lomme,52,86,24,162
Yekatit,6th,2010,Oromia,West Wellega,Mendi Hospital,88,65,18,171
Sene,10th,2010,Oromia,Arsi,Sude,28,67,35,130
Yekatit,6th,2010,Oromia,East Wellega,Guto Gida,26,51,65,142
Hamle,11th,2010,Oromia,Guji,Goro Dola,99,83,2,184
Ginbot,9th,2011,Oromia,West Wellega,Guliso,16,23,80,119
Sene,10th,2011,Oromia,Guji,Gumi Eldallo,8,70,38,116
Nehase,12th,2010,Oromia,Guji,Adola Town,13,21,72,106
Yekatit,6th,2009,Oromia,West Wellega,Haru,7,85,98,190
Teqemt,2nd,2011,Oromia,East Hararge,Girawa,18,32,56,106
Megabit,7th,2009,Oromia,West Hararge,Daro Lebu,8,48,76,132
Ginbot,9th,2009,Oromia,Arsi,Aseko,25,49,13,87
Sene,10th,2010,Oromia,Qeleme Wellega,Jimma Horo,19,69,2,90
Hedar,3rd,2011,Oromia,Arsi,Aseko,7,12,58,77
Hamle,11th,2009,Oromia,East Shewa,Fentale,33,94,1,128
Sene,10th,2009,Oromia,Horo Gudru Wellega,Horo,69,6,93,168
Yekatit,6th,2011,Oromia,Guji,Wadara,3,93,25,121
Hedar,3rd,2010,Oromia,East Hararge,Bisidimo Hospital,61,17,87,165
Megabit,7th,2010,Oromia,West Arsi,Dodola Town,80,85,62,227
Tir,5th,2011,Oromia,Robe Town,Robe Town,52,79,1,132
Megabit,7th,2011,Oromia,West Guji,Dugda Dawa,7,38,68,113
Sene,10th,2009,Oromia,Arsi,Ludehetosa,60,48,39,147
Hedar,3rd,2010,Oromia,Arsi,Chole,14,22,41,77
Meskerem,1st,2010,Oromia,Jimma,Nono Benja,44,87,14,145
Megabit,7th,2009,Oromia,Guji,Negele Town,87,77,92,256
Megabit,7th,2009,Oromia,South West Shewa,Woliso Rural,28,38,35,101
Hamle,11th,2010,Oromia,West Wellega,Gimbi,39,40,18,97
Megabit,7th,2010,Oromia,Bale,Delo Mena,66,48,4,118
Nehase,12th,2010,Oromia,Qeleme Wellega,Laloqile,16,52,25,93
Yekatit,6th,2009,Oromia,Borena,Moyale,13,44,56,113
Yekatit,6th,2011,Oromia,North Shewa,Degem,76,78,87,241
Hamle,11th,2009,Oromia,Ilu Aba Bora,Doreni,2,86,2,90
Yekatit,6th,2010,Oromia,West Shewa,Dendi,97,67,60,224
Hedar,3rd,2010,Oromia,South West Shewa,Seden Sodo,78,88,79,245
Ginbot,9th,2009,Oromia,South West Shewa,Ameya,36,53,1,90
Tahesas,4th,2011,Oromia,North Shewa,Wuchale,35,4,30,69
Megabit,7th,2009,Oromia,Bale,Delo Mena,5,55,55,115
Tahesas,4th,2010,Oromia,Guji,Gumi Eldallo,80,12,46,138
Hamle,11th,2009,Oromia,Arsi,Enkelo Wabe,81,90,72,243
Hedar,3rd,2010,Oromia,North Shewa,Dera,4,51,33,88
Miyazia,8th,2009,Oromia,West Hararge,Chiro Town,29,99,68,196
Tir,5th,2009,Oromia,South West Shewa,Dawo,74,8,80,162
Hedar,3rd,2010,Oromia,Robe Town,Robe Town,69,55,39,163
Nehase,12th,2010,Oromia,East Wellega,Gobu Seyo,32,97,3,132
Meskerem,1st,2011,Oromia,South West Shewa,Sodo Dac'Ha,48,95,26,169
Megabit,7th,2011,Oromia,East Wellega,Ebantu,18,53,21,92
Sene,10th,2009,Oromia,North Shewa,Debre Libanos,2,81,83,166
Tir,5th,2011,Oromia,East Hararge,Deder Town,82,96,18,196
Ginbot,9th,2011,Oromia,Guji,Bore,1,45,37,83
Hamle,11th,2010,Oromia,East Shewa,Fentale,52,54,30,136
Ginbot,9th,2011,Oromia,Arsi,Chole,17,22,19,58
Miyazia,8th,2011,Oromia,West Arsi,Dodola  Hospital,63,87,33,183
Tahesas,4th,2011,Oromia,West Hararge,Oda Bultum,53,97,35,185
Miyazia,8th,2010,Oromia,West Arsi,Kokosa  Hospital,2,28,30,60
Tahesas,4th,2010,Oromia,Bale,Dawe Serar,5,23,2,30
Ginbot,9th,2010,Oromia,Guji,Odo Shakiso,20,63,13,96
Megabit,7th,2010,Oromia,Ilu Aba Bora,Halu,51,0,39,90
Tahesas,4th,2010,Oromia,Jimma,Limu Kosa,10,9,9,28
Sene,10th,2009,Oromia,West Hararge,Hawi Gudina,24,86,2,112
Tir,5th,2010,Oromia,Jimma,Sekoru,18,34,53,105
Ginbot,9th,2011,Oromia,Jimma,Agaro Hospital,83,86,22,191
Miyazia,8th,2011,Oromia,Jimma,Shabe,8,1,43,52
Megabit,7th,2011,Oromia,Bale,Goba,55,69,6,130
Miyazia,8th,2009,Oromia,West Shewa,Nono,72,31,27,130
Miyazia,8th,2011,Oromia,East Hararge,Meta,15,99,95,209
Hedar,3rd,2010,Oromia,Horo Gudru Wellega,Gudru,94,85,91,270
Yekatit,6th,2010,Oromia,West Shewa,Gedo Hospital,32,38,55,125
Meskerem,1st,2011,Oromia,Guji,Adola Town,17,80,95,192
Hedar,3rd,2011,Oromia,Arsi,Enkelo Wabe,14,5,94,113
Hedar,3rd,2011,Oromia,East Hararge,Chelenko Hospital,99,80,47,226
Miyazia,8th,2011,Oromia,Qeleme Wellega,Dale Sedi,37,79,15,131
Tahesas,4th,2010,Oromia,West Shewa,Gojo Hospital,43,96,49,188
Megabit,7th,2010,Oromia,West Arsi,Siraro,69,84,44,197
Meskerem,1st,2011,Oromia,Arsi,Shirka,16,25,30,71
Tahesas,4th,2011,Oromia,South West Shewa,St.Luke Hospital,52,87,97,236
Yekatit,6th,2011,Oromia,Ilu Aba Bora,Didu,99,72,58,229
Tahesas,4th,2010,Oromia,West Shewa,Tibe Kutaye,59,62,28,149
Hedar,3rd,2011,Oromia,Ilu Aba Bora,Darimu,58,79,42,179
Sene,10th,2010,Oromia,Arsi,Deksis,92,16,27,135
Nehase,12th,2009,Oromia,West Hararge,Oda Bultum,62,77,21,160
Teqemt,2nd,2010,Oromia,Bale,Gasera,57,75,4,136
Miyazia,8th,2009,Oromia,South West Shewa,Dawo,0,34,23,57
Megabit,7th,2011,Oromia,East Hararge,Babile,8,21,98,127
Sene,10th,2009,Oromia,West Guji,Abaya,44,97,90,231
Meskerem,1st,2011,Oromia,Jimma,Seka Chhokorsa Hospital,12,16,68,96
Teqemt,2nd,2011,Oromia,Qeleme Wellega,Yemalogi Wolel,80,35,23,138
Tir,5th,2011,Oromia,South West Shewa,Tole,25,40,0,65
Tahesas,4th,2011,Oromia,West Shewa,Ejersa Lafo,48,55,95,198
Tir,5th,2010,Oromia,Arsi,Deksis,93,23,95,211
Tahesas,4th,2011,Oromia,West Shewa,Gindeberet Hospital,35,34,71,140
Tir,5th,2011,Oromia,North Shewa,Kuyu Hospital,69,68,77,214
Teqemt,2nd,2011,Oromia,Ilu Aba Bora,Ale,26,94,52,172
Tir,5th,2011,Oromia,Ilu Aba Bora,Bure,8,51,8,67
Ginbot,9th,2010,Oromia,South West Shewa,Wonchi,38,88,39,165
Hedar,3rd,2011,Oromia,East Shewa,Olanciti Hospital,10,14,33,57
Miyazia,8th,2010,Oromia,East Hararge,Haromaya Hospital,18,25,2,45
Teqemt,2nd,2011,Oromia,North Shewa,Jido,18,87,64,169
Teqemt,2nd,2010,Oromia,Sululta Town,Sululta Town,34,67,73,174
Ginbot,9th,2011,Oromia,Jimma,Shabe,17,73,0,90
Tir,5th,2010,Oromia,Arsi,Tiyo,12,95,19,126
Yekatit,6th,2010,Oromia,North Shewa,Degem,92,48,87,227
Megabit,7th,2010,Oromia,West Wellega,Lata Sibu,77,81,46,204
Miyazia,8th,2010,Oromia,East Wellega,Boneya Bushe,84,8,42,134
Sene,10th,2010,Oromia,West Wellega,Lata Sibu,28,62,24,114
Nehase,12th,2009,Oromia,East Hararge,Deder Town,54,12,29,95
Tir,5th,2011,Oromia,Buno Bedele,Bedele Zuriya,45,57,20,122
Tahesas,4th,2011,Oromia,Borena,El Way,13,31,5,49
Tahesas,4th,2011,Oromia,Jimma,Agaro Hospital,73,53,61,187
Miyazia,8th,2010,Oromia,West Wellega,Begi Hospital,65,76,15,156
Tahesas,4th,2010,Oromia,East Hararge,Babile Woreda,52,65,19,136
Nehase,12th,2009,Oromia,Qeleme Wellega,Dambi Dolo Hospital,56,16,22,94
Meskerem,1st,2011,Oromia,West Guji,Kercha,32,41,36,109
Miyazia,8th,2010,Oromia,South West Shewa,Goro,92,80,68,240
Yekatit,6th,2011,Oromia,East Shewa,Batu,3,0,10,13
Hedar,3rd,2011,Oromia,East Hararge,Bedeno,9,73,24,106
Hamle,11th,2010,Oromia,West Shewa,Bako Hospital,38,25,58,121
Ginbot,9th,2009,Oromia,Jimma,Seka Chekorsa,5,76,25,106
Yekatit,6th,2009,Oromia,West Shewa,Ejersa Lafo,35,46,65,146
Nehase,12th,2010,Oromia,Finfine Zuria,Walmera,86,86,5,177
Teqemt,2nd,2010,Oromia,Borena,Moyale,14,45,16,75
Tahesas,4th,2010,Oromia,West Shewa,Gojo Hospital,74,12,28,114
Hedar,3rd,2010,Oromia,West Guji,Hanbala,23,55,44,122
Hedar,3rd,2010,Oromia,West Wellega,Begi Hospital,61,7,74,142
Megabit,7th,2009,Oromia,North Shewa,Fiche Hospital,19,6,69,94
Miyazia,8th,2009,Oromia,West Shewa,Nono,45,52,95,192
Teqemt,2nd,2010,Oromia,East Shewa,Dugda,83,22,17,122
Meskerem,1st,2011,Oromia,Buno Bedele,Bedele Hospital,68,30,46,144
Hedar,3rd,2010,Oromia,East Wellega,Boneya Bushe,74,11,58,143
Megabit,7th,2011,Oromia,East Wellega,Haro Limu,40,55,70,165
Ginbot,9th,2011,Oromia,North Shewa,Were Jarso,19,19,61,99
Teqemt,2nd,2011,Oromia,West Guji,Bule Hora,63,39,0,102
Tahesas,4th,2010,Oromia,West Wellega,Nejo Rural,18,39,95,152
Ginbot,9th,2011,Oromia,West Wellega,Lata Sibu,27,9,98,134
Tahesas,4th,2011,Oromia,East Wellega,Guto Gida,75,74,30,179
Tir,5th,2010,Oromia,West Arsi,Bishan Guracha Town,41,73,59,173
Hedar,3rd,2010,Oromia,Horo Gudru Wellega,Jarte Jardga,48,6,6,60
Sene,10th,2009,Oromia,Guji,Aga Wayyu,95,83,85,263
Hedar,3rd,2010,Oromia,Borena,Yabelo Hospital,54,75,50,179
Meskerem,1st,2011,Oromia,Ilu Aba Bora,Algesachi,20,56,23,99
Tahesas,4th,2010,Oromia,West Wellega,Nole Kaba,74,97,89,260
Tir,5th,2010,Oromia,Arsi,Merti,42,25,9,76
Ginbot,9th,2011,Oromia,East Shewa,Olanciti Hospital,23,46,9,78
Hamle,11th,2010,Oromia,Jimma,Omo Nada Hospital,70,67,56,193
Hedar,3rd,2011,Oromia,West Shewa,Elifata,8,21,65,94
Nehase,12th,2010,Oromia,East Shewa,Batu,66,50,92,208
Meskerem,1st,2011,Oromia,Buno Bedele,Boricha,31,37,21,89
Tir,5th,2009,Oromia,Sululta Town,Sululta Town,75,43,18,136
Nehase,12th,2009,Oromia,North Shewa,Fiche Hospital,56,32,58,146
Yekatit,6th,2011,Oromia,East Hararge,Bisidimo Hospital,26,35,33,94
Nehase,12th,2010,Oromia,East Hararge,Bedeno,89,45,49,183
Hedar,3rd,2010,Oromia,Guji,Gumi Eldallo,42,37,63,142
Megabit,7th,2010,Oromia,Arsi,Bekoji Town,55,7,64,126
Megabit,7th,2011,Oromia,West Hararge,Burka Dimtu,27,69,12,108
Yekatit,6th,2011,Oromia,West Shewa,Metarobi,17,29,74,120
Teqemt,2nd,2010,Oromia,Arsi,Jeju,43,86,86,215
Nehase,12th,2009,Oromia,East Wellega,Gida Ayana,15,50,14,79
Meskerem,1st,2010,Oromia,East Wellega,Diga,69,76,70,215
Ginbot,9th,2011,Oromia,South West Shewa,Becho,67,45,80,192
Yekatit,6th,2011,Oromia,West Guji,Abaya,51,95,90,236
Yekatit,6th,2010,Oromia,East Hararge,Chelenko Hospital,41,52,10,103
Yekatit,6th,2010,Oromia,South West Shewa,Ameya,9,67,98,174
Megabit,7th,2009,Oromia,West Guji,Mkelka Soda,10,65,27,102
Tahesas,4th,2010,Oromia,Jimma,B/Tolyi,66,48,24,138
Nehase,12th,2010,Oromia,West Hararge,Hawi Gudina,54,22,10,86
Sene,10th,2011,Oromia,Buno Bedele,Bedele Zuriya,45,15,27,87
Hedar,3rd,2010,Oromia,West Shewa,Dendi,87,58,50,195
Tir,5th,2010,Oromia,Borena,Dilo,35,76,66,177
Yekatit,6th,2009,Oromia,East Shewa,Batu,12,9,31,52
Hamle,11th,2010,Oromia,West Arsi,Kore,93,0,88,181
Tir,5th,2010,Oromia,Arsi,Aseko,83,16,72,171
Sene,10th,2009,Oromia,North Shewa,Degem,7,6,5,18
Nehase,12th,2009,Oromia,West Wellega,Qiltu Kara,82,44,49,175
Hedar,3rd,2010,Oromia,West Wellega,Genji,9,69,94,172
Megabit,7th,2011,Oromia,Horo Gudru Wellega,Shambu Hospital,68,85,53,206
Tahesas,4th,2011,Oromia,North Shewa,Aleiltu,77,3,54,134
Tir,5th,2010,Oromia,West Shewa,Meta Waliqite,11,50,24,85
Tir,5th,2009,Oromia,Ilu Aba Bora,Algesachi,28,29,59,116
Megabit,7th,2009,Oromia,West Shewa,Elifata,63,85,50,198
Meskerem,1st,2011,Oromia,Ilu Aba Bora,Nono Sele,20,42,90,152
Hamle,11th,2009,Oromia,West Arsi,Dodola Town,71,4,79,154
Miyazia,8th,2011,Oromia,West Shewa,Guder Hosp,77,16,89,182
Hedar,3rd,2011,Oromia,East Hararge,Garemuleta Hospital,6,54,42,102
Hedar,3rd,2010,Oromia,West Shewa,Gindeberet Hospital,13,1,14,28
Miyazia,8th,2010,Oromia,East Hararge,Babile Woreda,96,38,52,186
Hamle,11th,2010,Oromia,Arsi,Dodota,28,24,18,70
Hedar,3rd,2010,Oromia,Qeleme Wellega,Jimma Horo,15,57,70,142
Megabit,7th,2009,Oromia,North Shewa,Were Jarso,0,71,9,80
Ginbot,9th,2010,Oromia,Buno Bedele,Bedele Zuriya,18,82,60,160
Meskerem,1st,2011,Oromia,Shashamane Town,Shashamane Town,2,31,94,127
Megabit,7th,2011,Oromia,East Wellega,Wama Hagelo,67,61,66,194
Megabit,7th,2011,Oromia,Guji,Aga Wayyu,37,37,65,139
Nehase,12th,2009,Oromia,Guji,Aga Wayyu,11,48,39,98
Tahesas,4th,2011,Oromia,Jimma,Omo Nada Hospital,60,22,38,120
Yekatit,6th,2009,Oromia,Arsi,Sude,45,8,22,75
Teqemt,2nd,2011,Oromia,Arsi,Deksis,42,10,56,108
Nehase,12th,2010,Oromia,Jimma,Agaro,36,57,91,184
Tir,5th,2011,Oromia,Horo Gudru Wellega,Gudru,73,96,5,174
Tir,5th,2010,Oromia,East Wellega,Wama Hagelo,88,98,71,257
Hamle,11th,2009,Oromia,Bale,Seweyna,3,40,20,63
Meskerem,1st,2010,Oromia,West Hararge,Bedesa Town,89,25,89,203
Megabit,7th,2010,Oromia,West Shewa,Dendi,12,12,93,117
Nehase,12th,2009,Oromia,East Hararge,Bisidimo Hospital,76,95,25,196
Megabit,7th,2009,Oromia,Bale,Gasera,0,58,84,142
Meskerem,1st,2011,Oromia,Guji,Hambela Wamena,16,49,67,132
Yekatit,6th,2010,Oromia,Bale,Dawe Qachen,42,33,86,161
Miyazia,8th,2011,Oromia,West Wellega,Boji Cheqorsa,87,1,57,145
Teqemt,2nd,2010,Oromia,West Shewa,Guder Hosp,6,3,87,96
Teqemt,2nd,2010,Oromia,West Shewa,Dano,44,7,6,57
Hedar,3rd,2011,Oromia,Borena,El Way,98,1,20,119
Tir,5th,2009,Oromia,Jimma,Mana,3,27,85,115
Megabit,7th,2009,Oromia,West Hararge,Burka Dimtu,19,21,9,49
Tahesas,4th,2010,Oromia,East Shewa,Liben,82,12,85,179
Hamle,11th,2009,Oromia,Bale,Meda Welabu,51,30,34,115
Hedar,3rd,2010,Oromia,East Shewa,Lomme,78,47,39,164
Meskerem,1st,2011,Oromia,East Hararge,Bedeno,14,8,49,71
Hedar,3rd,2010,Oromia,West Wellega,Ayira,50,47,61,158
Ginbot,9th,2010,Oromia,North Shewa,Degem,84,76,23,183
Megabit,7th,2011,Oromia,Jimma,Mancho,44,22,30,96
Miyazia,8th,2009,Oromia,West Shewa,Dendi,18,88,81,187
Yekatit,6th,2010,Oromia,West Wellega,Begi Hospital,91,79,23,193
Hedar,3rd,2010,Oromia,Horo Gudru Wellega,Jima Rare,19,98,72,189
Tir,5th,2010,Oromia,Arsi,Digeluna Tijo,23,18,57,98
Miyazia,8th,2009,Oromia,Jimma,Setema,16,13,38,67
Tir,5th,2010,Oromia,East Hararge,Fedis,65,76,68,209
Hamle,11th,2010,Oromia,Ambo Town,Ambo Town,58,92,21,171
Meskerem,1st,2011,Oromia,Qeleme Wellega,Dale Sedi,25,86,1,112
Ginbot,9th,2010,Oromia,South West Shewa,St.Luke Hospital,89,1,45,135
Miyazia,8th,2010,Oromia,East Hararge,Garemuleta Hospital,26,49,73,148
Megabit,7th,2009,Oromia,West Wellega,Yubdo,30,66,83,179
Miyazia,8th,2009,Oromia,East Hararge,Deder Town,40,90,1,131
Miyazia,8th,2009,Oromia,North Shewa,Dera,25,77,50,152
Megabit,7th,2011,Oromia,Borena,Dilo,1,57,50,108
Yekatit,6th,2011,Oromia,West Arsi,Gambo Hospital,21,77,5,103
Miyazia,8th,2011,Oromia,Horo Gudru Wellega,Horro Buluk,7,88,77,172
Miyazia,8th,2009,Oromia,East Hararge,Chelenko Hospital,74,55,15,144
Miyazia,8th,2010,Oromia,Buno Bedele,Dedesa,59,55,59,173
Ginbot,9th,2011,Oromia,West Arsi,Dodola Rural,14,28,13,55
Megabit,7th,2010,Oromia,West Shewa,Meta Waliqite,59,71,33,163
Yekatit,6th,2010,Oromia,Qeleme Wellega,Dambi Dollo,56,55,66,177
Yekatit,6th,2011,Oromia,Ambo Town,Ambo Town,74,85,35,194
Sene,10th,2009,Oromia,Ilu Aba Bora,Ale,77,83,77,237
Meskerem,1st,2010,Oromia,Borena,Gomole,85,79,94,258
Meskerem,1st,2011,Oromia,West Hararge,Guba Qoricha,34,9,89,132
Tahesas,4th,2011,Oromia,East Wellega,Boneya Bushe,37,13,72,122
Miyazia,8th,2011,Oromia,Ilu Aba Bora,Becho,81,83,58,222
Tir,5th,2009,Oromia,South West Shewa,Wonchi,49,80,16,145
Nehase,12th,2009,Oromia,West Arsi,Adaba,85,21,1,107
Megabit,7th,2011,Oromia,West Arsi,Kofele,44,69,6,119
Hedar,3rd,2011,Oromia,Guji,Negele Hospital,20,93,29,142
Teqemt,2nd,2011,Oromia,West Arsi,Shashemene Rural,8,35,89,132
Miyazia,8th,2010,Oromia,West Guji,Bule Hora Hospital,31,82,93,206
Hedar,3rd,2011,Oromia,Arsi,Dodota,11,95,40,146
Miyazia,8th,2010,Oromia,Borena,Dhas,29,77,40,146
Meskerem,1st,2011,Oromia,Bale,Dawe Qachen,33,56,3,92
Miyazia,8th,2010,Oromia,North Shewa,Degem,52,53,76,181
Tahesas,4th,2011,Oromia,Arsi,Chole,31,34,34,99
Teqemt,2nd,2011,Oromia,East Shewa,Dugda,78,47,5,130
Teqemt,2nd,2011,Oromia,East Hararge,Fedis,83,80,16,179
Sene,10th,2009,Oromia,West Arsi,Gambo Hospital,25,93,86,204
Meskerem,1st,2010,Oromia,Borena,Dhas,33,87,20,140
Nehase,12th,2010,Oromia,East Wellega,Leqa Dulecha,71,2,15,88
Hamle,11th,2009,Oromia,West Wellega,Genji,83,13,95,191
Megabit,7th,2009,Oromia,Finfine Zuria,Akaki,87,20,22,129
Sene,10th,2009,Oromia,East Hararge,Chinakesen,92,72,79,243
Sene,10th,2010,Oromia,East Wellega,Gida Ayana,73,37,82,192
Meskerem,1st,2011,Oromia,Woliso Town,Woliso Town,64,12,24,100
Nehase,12th,2009,Oromia,West Wellega,Lalo Asabi,27,22,85,134
Hamle,11th,2010,Oromia,East Wellega,Wayu Tuqa,6,87,44,137
Ginbot,9th,2009,Oromia,East Hararge,Aweday Town,51,34,52,137
Hedar,3rd,2011,Oromia,East Hararge,Girawa,0,2,72,74
Ginbot,9th,2011,Oromia,Ilu Aba Bora,Ale,48,86,22,156
Meskerem,1st,2011,Oromia,West Arsi,Bishan Guracha Town,54,16,70,140
Nehase,12th,2009,Oromia,East Shewa,Matahara,7,31,21,59
Teqemt,2nd,2010,Oromia,West Wellega,Ayira,97,52,39,188
Teqemt,2nd,2010,Oromia,Finfine Zuria,Holeta,23,49,9,81
Meskerem,1st,2010,Oromia,West Shewa,Abuna Gindeberet,70,65,73,208
Tir,5th,2011,Oromia,Jimma,Chora Boter,12,75,76,163
Tir,5th,2010,Oromia,East Wellega,Haro Limu,63,79,78,220
Tir,5th,2011,Oromia,East Hararge,Babile,45,66,38,149
Tir,5th,2010,Oromia,Arsi,Dodota,35,15,75,125
Megabit,7th,2009,Oromia,West Hararge,Chiro Zuriya,53,43,93,189
Hamle,11th,2009,Oromia,Bale,Delo Mena,60,84,82,226
Tir,5th,2010,Oromia,Horo Gudru Wellega,Abe Dengoro,52,83,50,185
Ginbot,9th,2010,Oromia,Arsi,Tiyo,14,14,94,122
Sene,10th,2011,Oromia,Guji,Shakiso Town,44,58,98,200
Sene,10th,2009,Oromia,Buno Bedele,Bedele Zuriya,99,15,87,201
Yekatit,6th,2010,Oromia,East Hararge,Aweday Town,74,30,5,109
Nehase,12th,2010,Oromia,Horo Gudru Wellega,Gudru,1,30,50,81
Hedar,3rd,2011,Oromia,West Hararge,Boke,31,1,46,78
Ginbot,9th,2011,Oromia,Jimma,Agaro Hospital,49,0,75,124
Megabit,7th,2009,Oromia,Horo Gudru Wellega,Amuru,95,80,99,274
Tir,5th,2009,Oromia,East Hararge,Meta,23,12,92,127
Sene,10th,2011,Oromia,West Hararge,Doba,26,16,7,49
Hedar,3rd,2010,Oromia,West Guji,Abaya,57,11,36,104
Megabit,7th,2010,Oromia,Arsi,Tena,14,24,42,80
Meskerem,1st,2011,Oromia,West Guji,Bule Hora Toun,70,44,55,169
Meskerem,1st,2010,Oromia,Jimma,Sigmo,83,23,33,139
Yekatit,6th,2010,Oromia,East Hararge,Aweday Town,77,40,30,147
Megabit,7th,2010,Oromia,West Shewa,Gindeberet Hospital,87,81,5,173
Yekatit,6th,2010,Oromia,Arsi,Guna,17,53,23,93
Yekatit,6th,2011,Oromia,East Wellega,Sasiga,81,12,49,142
Hamle,11th,2010,Oromia,Borena,Moyale Hospital,34,75,55,164
Miyazia,8th,2009,Oromia,Guji,Bore,12,40,50,102
Hamle,11th,2010,Oromia,Shashamane Town,Shashamane Town,51,26,27,104
Sene,10th,2009,Oromia,East Hararge,Goro Muti,26,86,61,173
Sene,10th,2010,Oromia,East Shewa,Dugda,0,71,68,139
Tir,5th,2010,Oromia,East Wellega,Gida Ayana,33,19,82,134
Hamle,11th,2010,Oromia,West Hararge,Chiro Hospital,15,37,61,113
Miyazia,8th,2011,Oromia,West Wellega,Boji Cheqorsa,88,39,2,129
Yekatit,6th,2009,Oromia,East Wellega,Wayu Tuqa,14,14,82,110
Hamle,11th,2009,Oromia,West Shewa,Jeldu,11,55,16,82
Miyazia,8th,2009,Oromia,West Shewa,Jibat,19,2,65,86
Hedar,3rd,2011,Oromia,Jimma,Kersa,85,58,64,207
Hedar,3rd,2010,Oromia,Guji,Negele Hospital,4,68,83,155
Ginbot,9th,2009,Oromia,East Wellega,Wayu Tuqa,26,88,24,138
Teqemt,2nd,2011,Oromia,Bale,Raitu,33,25,61,119
Tir,5th,2010,Oromia,South West Shewa,Seden Sodo,15,96,25,136
Miyazia,8th,2009,Oromia,South West Shewa,Goro,82,31,55,168
Yekatit,6th,2009,Oromia,Jimma,Mana,10,11,87,108
Hedar,3rd,2010,Oromia,Jimma,Limu Kosa,36,14,18,68
Ginbot,9th,2009,Oromia,Buno Bedele,Chewaqa,15,59,30,104
Tir,5th,2011,Oromia,West Hararge,Hawi Gudina,68,87,20,175
Teqemt,2nd,2010,Oromia,West Guji,Bule Hora Hospital,14,74,28,116
Ginbot,9th,2010,Oromia,Ilu Aba Bora,Nono Sele,17,61,9,87
Miyazia,8th,2011,Oromia,Arsi,Gololcha,92,0,60,152
Ginbot,9th,2011,Oromia,West Wellega,Babo Gembel,88,3,24,115
Tahesas,4th,2011,Oromia,West Arsi,Loke Hada Hospital,65,17,65,147
Megabit,7th,2009,Oromia,West Wellega,Gimbi Adventist Hospital,13,11,75,99
Sene,10th,2009,Oromia,Guji,Wadara,30,43,1,74
Ginbot,9th,2011,Oromia,Jimma,Gomma,95,94,9,198
Meskerem,1st,2010,Oromia,Ilu Aba Bora,Bilonopa,86,16,45,147
Tahesas,4th,2011,Oromia,Borena,Dubluk,47,35,96,178
Yekatit,6th,2009,Oromia,East Hararge,Haromaya Town,54,38,43,135
Miyazia,8th,2011,Oromia,East Hararge,Melka Belo,39,59,40,138
Megabit,7th,2010,Oromia,East Wellega,Sasiga,8,20,9,37
Teqemt,2nd,2010,Oromia,Gelan Town,Gelan Town,50,53,89,192
Tahesas,4th,2011,Oromia,West Hararge,Mesela,6,37,68,111
Teqemt,2nd,2010,Oromia,North Shewa,Hidabu Abote,1,5,85,91
Tahesas,4th,2011,Oromia,Finfine Zuria,Sandefa,7,50,72,129
Miyazia,8th,2011,Oromia,Bale,Berbere,44,14,83,141
Hamle,11th,2010,Oromia,West Hararge,Guba Qoricha,97,87,41,225
Sene,10th,2010,Oromia,East Hararge,Goro Gutu,70,64,27,161
Tir,5th,2011,Oromia,West Guji,Abaya,93,51,74,218
Ginbot,9th,2011,Oromia,West Arsi,Dodola Rural,63,9,21,93
Nehase,12th,2010,Oromia,South West Shewa,Ameya Hospital,89,73,27,189
Teqemt,2nd,2010,Oromia,Qeleme Wellega,Laloqile,86,79,30,195
Tahesas,4th,2010,Oromia,Buno Bedele,Bedele Hospital,35,75,4,114
Hamle,11th,2010,Oromia,Buno Bedele,Dedesa,59,59,3,121
Teqemt,2nd,2011,Oromia,West Wellega,Mendi Hospital,4,4,14,22
Hedar,3rd,2010,Oromia,Borena,Teltele,58,68,92,218
Tir,5th,2011,Oromia,West Shewa,Chelia,41,31,85,157
Yekatit,6th,2009,Oromia,East Wellega,Diga,80,44,24,148
Hedar,3rd,2011,Oromia,Horo Gudru Wellega,Shambu Hospital,32,29,1,62
Meskerem,1st,2011,Oromia,West Arsi,Nensebo,43,64,44,151
Yekatit,6th,2011,Oromia,Finfine Zuria,Berreh,21,52,73,146
Megabit,7th,2010,Oromia,West Hararge,Habro,56,36,23,115
Miyazia,8th,2011,Oromia,Jimma,Tiro Afeta,13,58,20,91
Tir,5th,2009,Oromia,West Arsi,Bishan Guracha Town,40,85,27,152
Hedar,3rd,2010,Oromia,Adama Special Town,Adama Town,93,95,53,241
Teqemt,2nd,2010,Oromia,North Shewa,Kimbibit,63,3,9,75
Ginbot,9th,2011,Oromia,West Arsi,Shala,26,44,64,134
Megabit,7th,2011,Oromia,Jimma,Dedo,1,89,16,106
Tir,5th,2011,Oromia,Guji,Uraga,8,21,23,52
Hedar,3rd,2011,Oromia,Bale,Goro,71,81,16,168
Tir,5th,2009,Oromia,Ilu Aba Bora,Yayu,45,61,59,165
Miyazia,8th,2009,Oromia,South West Shewa,Sodo Dac'Ha,74,10,39,123
Nehase,12th,2009,Oromia,North Shewa,Abichugna,76,14,42,132
Meskerem,1st,2010,Oromia,West Shewa,Ambo Town,67,52,16,135
Hedar,3rd,2010,Oromia,West Guji,Bule Hora Toun,42,63,53,158
Nehase,12th,2010,Oromia,Buno Bedele,Meko,12,46,80,138
Sene,10th,2011,Oromia,West Wellega,Guliso,8,63,43,114
Teqemt,2nd,2011,Oromia,Bale,Gasera,54,18,28,100
Tahesas,4th,2010,Oromia,East Hararge,Bisidimo Hospital,71,5,90,166
Teqemt,2nd,2011,Oromia,South West Shewa,Dawo,98,3,9,110
Sene,10th,2010,Oromia,East Wellega,Ebantu,96,46,75,217
Sene,10th,2011,Oromia,Horo Gudru Wellega,Jarte Jardga,5,69,90,164
Ginbot,9th,2011,Oromia,East Hararge,Gole Oda,17,45,98,160
Ginbot,9th,2011,Oromia,West Wellega,Seyo Nole,94,96,82,272
Nehase,12th,2010,Oromia,Jimma,O/Beyam,23,7,56,86
Teqemt,2nd,2010,Oromia,Arsi,Shenan Kolu,41,94,96,231
Yekatit,6th,2010,Oromia,West Arsi,Kore,57,64,61,182
Ginbot,9th,2010,Oromia,North Shewa,Fichetown,76,2,43,121
Ginbot,9th,2009,Oromia,Sebeta Town,Sebeta Town,33,10,9,52
Megabit,7th,2010,Oromia,East Wellega,Guto Gida,27,81,46,154
Ginbot,9th,2011,Oromia,West Shewa,Ginde Beret,85,67,97,249
Hedar,3rd,2011,Oromia,East Hararge,Babile,52,71,79,202
Tir,5th,2009,Oromia,Borena,Yabelo,93,11,84,188
Miyazia,8th,2009,Oromia,Bale,Ginir Town,84,93,83,260
Miyazia,8th,2010,Oromia,Gelan Town,Gelan Town,56,49,75,180
Teqemt,2nd,2010,Oromia,Nekemte Town,Nekemte Town,24,65,4,93
Miyazia,8th,2009,Oromia,Guji,Wadara,18,72,36,126
Teqemt,2nd,2011,Oromia,West Hararge,Oda Bultum,53,72,18,143
Hamle,11th,2009,Oromia,North Shewa,Kuyu Hospital,37,90,26,153
Yekatit,6th,2010,Oromia,Jimma,Agaro,5,70,76,151
Miyazia,8th,2011,Oromia,Nekemte Town,Nekemte Town,35,67,70,172
Sene,10th,2009,Oromia,Qeleme Wellega,Hawa Gelan,70,57,44,171
Hamle,11th,2009,Oromia,South West Shewa,Tulu Bolo Hospital,20,95,6,121
Hamle,11th,2010,Oromia,East Hararge,Kombolicha,89,34,59,182
Yekatit,6th,2009,Oromia,East Wellega,Ebantu,54,6,33,93
Ginbot,9th,2010,Oromia,West Wellega,Nole Kaba,38,93,46,177
Tir,5th,2010,Oromia,West Hararge,Burka Dimtu,9,67,96,172
Sene,10th,2009,Oromia,East Wellega,Leqa Dulecha,81,68,81,230
Nehase,12th,2009,Oromia,West Shewa,Tibe Kutaye,23,24,45,92
Hedar,3rd,2011,Oromia,East Wellega,Leqa Dulecha,72,44,53,169
Hedar,3rd,2010,Oromia,Borena,Arero,63,47,78,188
Miyazia,8th,2010,Oromia,West Hararge,Tulo,21,11,11,43
Nehase,12th,2010,Oromia,East Hararge,Kersa Eh,95,12,53,160
Sene,10th,2010,Oromia,Bale,Gasera,23,25,0,48
Hedar,3rd,2010,Oromia,Bale,Seweyna,74,4,37,115
Tir,5th,2010,Oromia,Jimma,B/Tolyi,18,40,72,130
Megabit,7th,2011,Oromia,Borena,Meyo,37,4,92,133
Miyazia,8th,2009,Oromia,West Wellega,Nole Kaba,42,26,75,143
Ginbot,9th,2009,Oromia,Jimma,Tiro Afeta,28,36,52,116
Yekatit,6th,2011,Oromia,Arsi,Deksis,19,32,69,120
Tir,5th,2010,Oromia,East Hararge,Haromaya Rural,63,45,11,119
Yekatit,6th,2009,Oromia,Guji,Wadara,11,10,32,53
Teqemt,2nd,2010,Oromia,North Shewa,Fichetown,66,92,78,236
Tir,5th,2010,Oromia,Guji,Liben,79,74,15,168
Yekatit,6th,2009,Oromia,Finfine Zuria,Walmera,94,40,93,227
Miyazia,8th,2010,Oromia,North Shewa,Abichugna,84,44,5,133
Ginbot,9th,2009,Oromia,Ilu Aba Bora,Bure,90,70,28,188
Tahesas,4th,2011,Oromia,Buno Bedele,Dedesa,71,88,85,244
Yekatit,6th,2009,Oromia,West Shewa,Chelia,88,90,27,205
Miyazia,8th,2009,Oromia,Shashamane Town,Shashamane Town,87,11,86,184
Tahesas,4th,2011,Oromia,Bale,Seweyna,70,86,49,205
Miyazia,8th,2010,Oromia,West Wellega,Begi,66,30,92,188
Teqemt,2nd,2010,Oromia,Borena,Dilo,85,1,23,109
Tahesas,4th,2010,Oromia,Arsi,Shirka,9,68,98,175
Megabit,7th,2010,Oromia,West Arsi,Arsi Negele Rural,4,29,99,132
Nehase,12th,2009,Oromia,Finfine Zuria,Sandefa,24,22,10,56
Hamle,11th,2010,Oromia,West Shewa,Dendi,69,18,52,139
Sene,10th,2009,Oromia,Horo Gudru Wellega,Hababo Guduru,98,65,60,223
Megabit,7th,2010,Oromia,West Shewa,Ginde Beret,66,71,19,156
Ginbot,9th,2009,Oromia,Jimma,O/Beyam,88,66,2,156
Tir,5th,2009,Oromia,East Hararge,Bedeno,34,77,65,176
Teqemt,2nd,2011,Oromia,Arsi,Sude,14,66,13,93
Tahesas,4th,2010,Oromia,Bale,Sinana,12,33,42,87
Hedar,3rd,2010,Oromia,Buno Bedele,Diga,67,80,24,171
Tir,5th,2011,Oromia,West Wellega,Nejo Hospital,56,27,50,133
Sene,10th,2009,Oromia,Arsi,Deksis,95,32,86,213
Tir,5th,2010,Oromia,Guji,Saba Boru,80,21,79,180
Miyazia,8th,2009,Oromia,Finfine Zuria,Sandefa,49,52,19,120
Ginbot,9th,2009,Oromia,East Wellega,Limu,78,10,58,146
Ginbot,9th,2010,Oromia,West Hararge,Oda Bultum,79,58,78,215
Yekatit,6th,2011,Oromia,Guji,Adola Reda,40,55,92,187
Miyazia,8th,2009,Oromia,East Wellega,Gudeyabila,97,63,18,178
Tir,5th,2010,Oromia,Arsi,Tena,72,93,62,227
Miyazia,8th,2011,Oromia,West Shewa,Ginde Beret,83,3,87,173
Yekatit,6th,2011,Oromia,Ilu Aba Bora,Bilonopa,80,39,20,139
Ginbot,9th,2010,Oromia,Ilu Aba Bora,Metu Town,17,90,24,131
Ginbot,9th,2011,Oromia,Borena,Moyale,73,45,46,164
Miyazia,8th,2009,Oromia,West Shewa,Tikur Enchini,96,49,19,164
Teqemt,2nd,2010,Oromia,West Shewa,Liban Jawi,31,27,70,128
Ginbot,9th,2009,Oromia,Ilu Aba Bora,Ale,1,53,30,84
Yekatit,6th,2010,Oromia,West Shewa,Ejersa Lafo,11,94,37,142
Hedar,3rd,2010,Oromia,West Guji,Mkelka Soda,22,61,31,114
Ginbot,9th,2009,Oromia,Bale,Robe Town,26,83,37,146
Sene,10th,2010,Oromia,Bale,Ginir,10,75,67,152
Hedar,3rd,2010,Oromia,Ilu Aba Bora,Didu,50,54,22,126
Nehase,12th,2009,Oromia,Bale,Agarfa,41,77,1,119
Nehase,12th,2010,Oromia,West Hararge,Doba,6,48,23,77
Sene,10th,2009,Oromia,Arsi,Ludehetosa,60,36,56,152
Hamle,11th,2009,Oromia,Jimma,Guma,78,82,95,255
Megabit,7th,2009,Oromia,West Shewa,Dendi,22,30,71,123
Meskerem,1st,2010,Oromia,Arsi,Enkelo Wabe,45,78,0,123
Meskerem,1st,2010,Oromia,Horo Gudru Wellega,Amuru,56,42,10,108
Meskerem,1st,2011,Oromia,East Hararge,Chelenko Hospital,91,22,46,159
Miyazia,8th,2011,Oromia,West Guji,Bule Hora Toun,79,92,22,193
Meskerem,1st,2010,Oromia,Arsi,Ludehetosa,5,70,60,135
Megabit,7th,2010,Oromia,Nekemte Town,Nekemte Town,45,98,5,148
Tir,5th,2009,Oromia,West Hararge,Daro Lebu,52,20,43,115
Ginbot,9th,2011,Oromia,West Guji,Suro Barguda,63,95,18,176
Miyazia,8th,2011,Oromia,Borena,Dubluk,57,19,11,87
Miyazia,8th,2010,Oromia,South West Shewa,Dawo,18,38,57,113
Ginbot,9th,2009,Oromia,North Shewa,Fiche Hospital,17,73,77,167
Nehase,12th,2010,Oromia,North Shewa,Degem,64,37,2,103
Tir,5th,2010,Oromia,Bale,Delo Mena,16,40,53,109
Meskerem,1st,2011,Oromia,Finfine Zuria,Walmera,60,52,12,124
Yekatit,6th,2010,Oromia,South West Shewa,Kersana Malima,53,67,7,127
Tir,5th,2010,Oromia,West Hararge,Doba,42,48,76,166
Hamle,11th,2009,Oromia,West Wellega,Gimbi,9,1,31,41
Miyazia,8th,2009,Oromia,West Hararge,Chiro Zuriya,55,94,68,217
Tir,5th,2009,Oromia,Arsi,Shirka,83,91,53,227
Nehase,12th,2010,Oromia,North Shewa,Yaya Gulele,87,93,30,210
Miyazia,8th,2010,Oromia,Shashamane Town,Shashamane Town,46,79,84,209
Hamle,11th,2010,Oromia,East Hararge,Haromaya Rural,7,60,66,133
Tahesas,4th,2011,Oromia,Arsi,Dodota,52,95,2,149
Megabit,7th,2011,Oromia,Horo Gudru Wellega,Horro Buluk,60,60,2,122
Miyazia,8th,2009,Oromia,East Shewa,Mojo,48,51,38,137
Miyazia,8th,2010,Oromia,Horo Gudru Wellega,Jima Rare,29,22,89,140
Tir,5th,2010,Oromia,Jimma,Tiro Afeta,21,81,55,157
Hamle,11th,2010,Oromia,West Wellega,Lalo Asabi,14,24,73,111
Hamle,11th,2010,Oromia,Horo Gudru Wellega,Abe Dengoro,2,29,93,124
Sene,10th,2011,Oromia,West Wellega,Mendi Town,70,59,20,149
Tahesas,4th,2010,Oromia,Qeleme Wellega,Laloqile,99,78,97,274
Hedar,3rd,2010,Oromia,West Wellega,Nejo Town,56,21,61,138
Hedar,3rd,2010,Oromia,Ilu Aba Bora,Metu Rural,32,53,78,163
Sene,10th,2009,Oromia,West Hararge,Hawi Gudina,81,88,43,212
Hedar,3rd,2011,Oromia,Finfine Zuria,Sebeta Awas,0,86,29,115
Meskerem,1st,2011,Oromia,Jimma,Guma,48,74,1,123
Ginbot,9th,2010,Oromia,Guji,Negele Town,16,12,21,49
Yekatit,6th,2011,Oromia,Ilu Aba Bora,Halu,30,53,54,137
Tir,5th,2011,Oromia,West Hararge,Meiso,66,9,58,133
Tir,5th,2009,Oromia,Jimma,Omonada,27,78,48,153
Miyazia,8th,2009,Oromia,East Wellega,Haro Limu,51,90,25,166
Meskerem,1st,2010,Oromia,Jimma,Sigmo,67,55,1,123
Tahesas,4th,2011,Oromia,Bishoftu Town,Bishoftu Town,34,60,62,156
Meskerem,1st,2010,Oromia,Guji,Gumi Eldallo,27,0,99,126
Yekatit,6th,2009,Oromia,West Wellega,Jarso,57,68,30,155
Tir,5th,2011,Oromia,West Shewa,Bako Hospital,87,40,5,132
Tahesas,4th,2011,Oromia,Guji,Adola Reda,78,62,91,231
Megabit,7th,2009,Oromia,Shashamane Town,Shashamane Town,64,2,79,145
Tahesas,4th,2010,Oromia,West Shewa,Inchini Hospital,35,94,94,223
Tir,5th,2011,Oromia,Jimma,Sigmo,39,12,3,54
Nehase,12th,2010,Oromia,West Hararge,Gemechis,3,65,8,76
Tir,5th,2010,Oromia,Borena,Arero,67,32,41,140
Miyazia,8th,2009,Oromia,North Shewa,Girar Jarso,71,88,81,240
Meskerem,1st,2010,Oromia,West Arsi,Siraro,60,89,32,181
Nehase,12th,2009,Oromia,Finfine Zuria,Walmera,44,84,5,133
Megabit,7th,2009,Oromia,Horo Gudru Wellega,Jima Rare,87,34,71,192
Tahesas,4th,2010,Oromia,East Hararge,Deder Town,8,70,40,118
Ginbot,9th,2010,Oromia,West Hararge,Mesela,46,30,40,116
Megabit,7th,2010,Oromia,Horo Gudru Wellega,Abay Chomen,13,97,15,125
Miyazia,8th,2010,Oromia,Arsi,Sire,23,16,5,44
Tir,5th,2009,Oromia,Finfine Zuria,Holeta,57,71,2,130
Meskerem,1st,2010,Oromia,Buno Bedele,Bedele Hospital,1,86,84,171
Hedar,3rd,2010,Oromia,West Wellega,Begi Hospital,67,92,72,231
Sene,10th,2009,Oromia,Buno Bedele,Gechi,32,41,66,139
Miyazia,8th,2011,Oromia,Ilu Aba Bora,Hurumu,82,45,50,177
Sene,10th,2009,Oromia,Dukem Town,Dukem Town,97,28,94,219
Ginbot,9th,2010,Oromia,Jimma,Dedo,18,74,59,151
Ginbot,9th,2010,Oromia,Ilu Aba Bora,Bilonopa,96,97,35,228
Megabit,7th,2010,Oromia,South West Shewa,Tulu Bolo Hospital,86,48,33,167
Hedar,3rd,2011,Oromia,East Hararge,Haromaya Rural,94,25,72,191
Teqemt,2nd,2011,Oromia,South West Shewa,Tulu Bolo Hospital,47,78,3,128
Miyazia,8th,2009,Oromia,North Shewa,Dera Hospital,18,38,4,60
Megabit,7th,2010,Oromia,West Arsi,Kofele,75,70,56,201
Tahesas,4th,2010,Oromia,East Hararge,Meyu Muleke,36,96,20,152
Teqemt,2nd,2010,Oromia,Buno Bedele,Bedele Zuriya,86,92,66,244
Meskerem,1st,2011,Oromia,West Arsi,Shala,76,73,74,223
Tahesas,4th,2011,Oromia,Gelan Town,Gelan Town,17,6,5,28
Megabit,7th,2009,Oromia,Borena,Moyale,87,53,63,203
Yekatit,6th,2010,Oromia,Arsi,Shenan Kolu,29,34,85,148
Nehase,12th,2010,Oromia,North Shewa,Hidabu Abote,82,42,1,125
Tir,5th,2010,Oromia,West Shewa,Meta Waliqite,75,26,86,187
Sene,10th,2011,Oromia,West Guji,Mkelka Soda,70,70,40,180
Miyazia,8th,2011,Oromia,East Shewa,Fentale,89,48,8,145
Hedar,3rd,2010,Oromia,North Shewa,Kuyu,80,51,51,182
Miyazia,8th,2009,Oromia,West Wellega,Begi,26,41,11,78
Hamle,11th,2010,Oromia,Buno Bedele,Bedele Town,41,57,64,162
Yekatit,6th,2010,Oromia,West Shewa,Ilu Galan,16,83,50,149
Tir,5th,2009,Oromia,Buno Bedele,Dedesa,68,41,32,141
Miyazia,8th,2009,Oromia,West Arsi,Wondo,58,7,36,101
Tahesas,4th,2011,Oromia,West Hararge,Anchar,78,83,58,219
Sene,10th,2011,Oromia,East Wellega,Ebantu,30,49,53,132
Megabit,7th,2009,Oromia,Buno Bedele,Bedele Zuriya,64,29,54,147
Nehase,12th,2010,Oromia,West Arsi,Kore,43,52,19,114
Meskerem,1st,2011,Oromia,Borena,Wachile,10,93,88,191
Tir,5th,2010,Oromia,North Shewa,Dera,33,96,25,154
Meskerem,1st,2010,Oromia,Arsi,Amigna,28,99,27,154
Megabit,7th,2010,Oromia,Guji,Anna Sora,23,86,70,179
Hamle,11th,2009,Oromia,Arsi,Seru,21,7,0,28
Meskerem,1st,2010,Oromia,North Shewa,Debre Libanos,14,30,39,83
Megabit,7th,2010,Oromia,East Hararge,Kumbi,35,64,86,185
Ginbot,9th,2010,Oromia,West Arsi,Wondo,77,84,94,255
Ginbot,9th,2011,Oromia,Qeleme Wellega,Laloqile,8,31,59,98
Nehase,12th,2010,Oromia,Gelan Town,Gelan Town,27,84,2,113
Teqemt,2nd,2010,Oromia,Qeleme Wellega,Seyo,0,0,84,84
Megabit,7th,2009,Oromia,Guji,Gumi Eldallo,68,67,54,189
Sene,10th,2009,Oromia,Horo Gudru Wellega,Shambu Hospital,11,11,67,89
Tir,5th,2011,Oromia,West Wellega,Jarso,1,92,82,175
Tir,5th,2010,Oromia,Guji,Uraga,70,12,20,102
Ginbot,9th,2009,Oromia,West Wellega,Haru,93,1,98,192
Tahesas,4th,2011,Oromia,Borena,Dire,4,28,5,37
Ginbot,9th,2011,Oromia,West Shewa,Gedo Hospital,76,23,12,111
Yekatit,6th,2010,Oromia,Arsi,Merti,65,12,14,91
Megabit,7th,2009,Oromia,East Hararge,Haromaya Hospital,25,54,95,174
Tir,5th,2009,Oromia,Jimma,Limu Seka,36,68,51,155
Megabit,7th,2011,Oromia,East Hararge,Goro Gutu,63,65,49,177
Nehase,12th,2010,Oromia,West Shewa,Tikur Enchini,17,31,33,81
Tir,5th,2011,Oromia,West Shewa,Abuna Gindeberet,40,94,19,153
Nehase,12th,2010,Oromia,West Guji,Bule Hora Toun,41,94,46,181
Tir,5th,2009,Oromia,East Hararge,Gursum,66,88,36,190
Yekatit,6th,2009,Oromia,Guji,Saba Boru,30,72,36,138
Tahesas,4th,2011,Oromia,Qeleme Wellega,Yemalogi Wolel,54,6,19,79
Sene,10th,2010,Oromia,West Hararge,Mesela,39,99,86,224
Ginbot,9th,2009,Oromia,East Shewa,Adea,47,23,0,70
Nehase,12th,2010,Oromia,West Wellega,Boji Dermeji,62,2,84,148
Teqemt,2nd,2010,Oromia,West Guji,Bule Hora Toun,70,75,72,217
Miyazia,8th,2009,Oromia,Arsi,Munesa,78,6,7,91
Yekatit,6th,2011,Oromia,South West Shewa,Wonchi,48,79,87,214
Nehase,12th,2010,Oromia,Jimma,Tiro Afeta,82,8,86,176
Sene,10th,2011,Oromia,West Arsi,Siraro,11,67,89,167
Hedar,3rd,2011,Oromia,Qeleme Wellega,Dale Sedi,95,45,42,182
Meskerem,1st,2010,Oromia,Jimma,Limu Seka,14,3,52,69
Tahesas,4th,2011,Oromia,East Hararge,Midega Tole,62,43,73,178
Tahesas,4th,2010,Oromia,West Hararge,Chiro Zuriya,75,56,49,180
Hedar,3rd,2011,Oromia,Sebeta Town,Sebeta Town,65,14,70,149
Tahesas,4th,2010,Oromia,West Guji,Suro Barguda,59,99,61,219
Megabit,7th,2010,Oromia,South West Shewa,St.Luke Hospital,54,75,85,214
Hedar,3rd,2010,Oromia,West Hararge,Oda Bultum,78,72,69,219
Yekatit,6th,2010,Oromia,East Shewa,Adami Tulu Jido Kombolcha,92,13,20,125
Miyazia,8th,2010,Oromia,East Hararge,Midega Tole,9,46,44,99
Ginbot,9th,2011,Oromia,East Hararge,Kombolicha,69,90,66,225
Ginbot,9th,2011,Oromia,Jimma,Nono Benja,29,67,96,192
Tir,5th,2009,Oromia,West Arsi,Kokosa,68,27,32,127
Megabit,7th,2011,Oromia,West Wellega,Genji,2,59,38,99
Megabit,7th,2011,Oromia,West Hararge,Hawi Gudina,9,27,30,66
Sene,10th,2011,Oromia,West Shewa,Chelia,82,55,20,157
Ginbot,9th,2011,Oromia,West Wellega,Yubdo,90,70,10,170
Nehase,12th,2010,Oromia,Bale,Dawe Qachen,19,31,1,51
Tir,5th,2009,Oromia,East Wellega,Haro Limu,85,10,47,142
Nehase,12th,2010,Oromia,Nekemte Town,Nekemte Town,30,88,20,138
Miyazia,8th,2010,Oromia,Ilu Aba Bora,Doreni,71,54,81,206
Hamle,11th,2009,Oromia,North Shewa,Girar Jarso,4,39,43,86
Miyazia,8th,2009,Oromia,Jimma,Gomma,59,70,24,153
Miyazia,8th,2009,Oromia,Bale,Delo Mena,41,70,45,156
Tir,5th,2011,Oromia,Bale,Meda Welabu,56,55,94,205
Sene,10th,2009,Oromia,Arsi,Ludehetosa,20,14,52,86
Yekatit,6th,2011,Oromia,Bale,Goba,67,80,78,225
Nehase,12th,2009,Oromia,East Hararge,Jarso,90,73,9,172
Ginbot,9th,2011,Oromia,Buno Bedele,Chewaqa,70,80,85,235
Yekatit,6th,2011,Oromia,East Hararge,Girawa,18,48,18,84
Megabit,7th,2009,Oromia,West Wellega,Seyo Nole,18,92,26,136
Megabit,7th,2010,Oromia,Finfine Zuria,Sebeta Awas,77,37,70,184
Ginbot,9th,2009,Oromia,West Shewa,Tikur Enchini,26,65,46,137
Megabit,7th,2009,Oromia,Jimma,Mana,19,20,70,109
Tahesas,4th,2010,Oromia,Horo Gudru Wellega,Abe Dengoro,56,98,60,214
Meskerem,1st,2010,Oromia,West Shewa,Elifata,4,64,3,71
Yekatit,6th,2010,Oromia,West Arsi,Hebal Arsi,14,13,97,124
Sene,10th,2009,Oromia,West Arsi,Nensebo,95,22,10,127
Yekatit,6th,2010,Oromia,Guji,Anna Sora,99,60,23,182
Megabit,7th,2010,Oromia,Jimma,Limu Kosa,17,85,20,122
Megabit,7th,2011,Oromia,West Wellega,Begi,97,66,96,259
Hedar,3rd,2010,Oromia,West Wellega,Gimbi Rural,99,49,46,194
Megabit,7th,2010,Oromia,West Hararge,Gelemso Hospital,81,34,23,138
Ginbot,9th,2011,Oromia,Qeleme Wellega,Kake Hosp,42,9,33,84
Sene,10th,2009,Oromia,Guji,Liben,69,73,14,156
Tahesas,4th,2010,Oromia,East Hararge,Goro Gutu,18,64,75,157
Nehase,12th,2009,Oromia,Qeleme Wellega,Gidami,4,39,81,124
Teqemt,2nd,2011,Oromia,Guji,Saba Boru,75,20,76,171
Miyazia,8th,2010,Oromia,Horo Gudru Wellega,Abay Chomen,78,0,94,172
Yekatit,6th,2009,Oromia,West Guji,Bule Hora Toun,55,91,74,220
Hedar,3rd,2011,Oromia,Jimma,Seka Chekorsa,92,83,97,272
Yekatit,6th,2010,Oromia,Borena,Dilo,71,71,49,191
Nehase,12th,2010,Oromia,West Wellega,Seyo Nole,22,79,92,193
Miyazia,8th,2011,Oromia,West Arsi,Nensebo,55,96,54,205
Tir,5th,2010,Oromia,Qeleme Wellega,Seyo,57,54,8,119
Tahesas,4th,2010,Oromia,Horo Gudru Wellega,Horro Buluk,23,99,81,203
Meskerem,1st,2011,Oromia,Buno Bedele,Bedele Town,7,76,93,176
Nehase,12th,2009,Oromia,Ilu Aba Bora,Nono Sele,61,3,74,138
Sene,10th,2009,Oromia,Arsi,Chole,95,38,65,198
Meskerem,1st,2011,Oromia,East Shewa,Adama,91,61,28,180
Teqemt,2nd,2011,Oromia,West Wellega,Seyo Nole,71,91,26,188
Miyazia,8th,2011,Oromia,North Shewa,Kuyu,4,9,35,48
Yekatit,6th,2009,Oromia,Bale,Goba,8,50,87,145
Ginbot,9th,2010,Oromia,South West Shewa,Woliso Rural,42,44,9,95
Yekatit,6th,2011,Oromia,Horo Gudru Wellega,Shambu Town,78,4,82,164
Tir,5th,2009,Oromia,West Shewa,Jeldu,3,60,50,113
Ginbot,9th,2011,Oromia,Bale,Dawe Serar,73,19,39,131
Miyazia,8th,2009,Oromia,West Arsi,Gedeb Asasa,77,82,34,193
Ginbot,9th,2009,Oromia,East Wellega,Sasiga,68,19,59,146
Hamle,11th,2010,Oromia,West Wellega,Boji Cheqorsa,91,12,2,105
Tir,5th,2011,Oromia,Bale,Goba Town,33,56,72,161
Hamle,11th,2009,Oromia,West Hararge,Doba,75,38,33,146
Miyazia,8th,2010,Oromia,East Shewa,Gimbichu,93,25,60,178
Sene,10th,2011,Oromia,East Wellega,Boneya Bushe,22,26,62,110
Ginbot,9th,2010,Oromia,Arsi,Tena,48,74,30,152
Ginbot,9th,2011,Oromia,West Wellega,Mene Sibu,95,7,26,128
Ginbot,9th,2011,Oromia,West Shewa,Tibe Kutaye,24,7,63,94
Hamle,11th,2009,Oromia,West Arsi,Arsi Negele Town,28,53,18,99
Tir,5th,2009,Oromia,Arsi,Amigna,83,80,94,257
Sene,10th,2009,Oromia,East Hararge,Bisidimo Hospital,96,79,56,231
Hamle,11th,2009,Oromia,South West Shewa,Kersana Malima,82,11,65,158
Nehase,12th,2009,Oromia,North Shewa,Wuchale,1,5,6,12
Meskerem,1st,2010,Oromia,West Guji,Abaya,34,43,74,151
Ginbot,9th,2011,Oromia,Horo Gudru Wellega,Gudru,72,33,90,195
Megabit,7th,2011,Oromia,Bishoftu Town,Bishoftu Town,55,95,41,191
Hedar,3rd,2010,Oromia,West Hararge,Meiso,52,21,48,121
Megabit,7th,2009,Oromia,East Hararge,Kumbi,79,39,45,163
Nehase,12th,2009,Oromia,East Hararge,Kumbi,59,98,79,236
Meskerem,1st,2010,Oromia,West Shewa,Ginde Beret,20,30,18,68
Ginbot,9th,2010,Oromia,West Guji,Suro Barguda,50,57,59,166
Hamle,11th,2009,Oromia,Borena,Dubluk,82,24,11,117
Tir,5th,2011,Oromia,Arsi,Deksis,9,7,13,29
Ginbot,9th,2010,Oromia,West Arsi,Shala,79,39,99,217
Miyazia,8th,2010,Oromia,South West Shewa,Dawo,5,72,34,111
Yekatit,6th,2009,Oromia,West Shewa,Jibat,9,0,14,23
Megabit,7th,2009,Oromia,East Hararge,Gole Oda,61,12,57,130
Nehase,12th,2010,Oromia,East Shewa,Adami Tulu Jido Kombolcha,11,25,51,87
Sene,10th,2010,Oromia,West Guji,Bule Hora Toun,26,8,81,115
Tir,5th,2011,Oromia,West Arsi,Dodola  Hospital,17,92,74,183
Ginbot,9th,2010,Oromia,East Hararge,Fedis,74,81,66,221
Megabit,7th,2010,Oromia,West Wellega,Nejo Hospital,91,93,20,204
Tir,5th,2010,Oromia,East Shewa,Boset,33,33,84,150
Tahesas,4th,2011,Oromia,West Shewa,Nono,27,47,83,157
Hedar,3rd,2010,Oromia,Guji,Liben,23,31,36,90
Meskerem,1st,2010,Oromia,East Hararge,Midega Tole,66,26,63,155
Megabit,7th,2009,Oromia,West Arsi,Dodola Town,53,99,65,217
Ginbot,9th,2011,Oromia,West Hararge,West Harerge	Gumbi Bordede,18,81,60,159
Hedar,3rd,2011,Oromia,East Hararge,Melka Belo,84,88,88,260
Tir,5th,2011,Oromia,Qeleme Wellega,Dale Wabera,72,49,54,175
Sene,10th,2010,Oromia,Bale,Raitu,61,50,36,147
Hamle,11th,2010,Oromia,East Shewa,Batu,47,32,61,140
Nehase,12th,2009,Oromia,East Wellega,Gobu Seyo,44,40,83,167
Yekatit,6th,2010,Oromia,Dukem Town,Dukem Town,54,58,65,177
Sene,10th,2009,Oromia,Bale,Berbere,4,86,93,183
Ginbot,9th,2011,Oromia,Ilu Aba Bora,Metu Rural,99,64,25,188
Nehase,12th,2009,Oromia,West Wellega,Kundala,58,62,62,182
Ginbot,9th,2009,Oromia,West Guji,Bule Hora Hospital,18,49,30,97
Sene,10th,2011,Oromia,Ilu Aba Bora,Metu Rural,32,76,90,198
Sene,10th,2011,Oromia,East Wellega,Guto Gida,83,99,1,183
Nehase,12th,2009,Oromia,North Shewa,Kimbibit,27,38,21,86
Sene,10th,2011,Oromia,Qeleme Wellega,Dale Sedi,62,9,90,161
Yekatit,6th,2010,Oromia,East Shewa,Fentale,75,92,69,236
Tir,5th,2010,Oromia,Guji,Goro Dola,25,35,61,121
Nehase,12th,2009,Oromia,East Hararge,Girawa,24,27,35,86
Yekatit,6th,2010,Oromia,Ilu Aba Bora,Halu,33,29,54,116
Ginbot,9th,2009,Oromia,West Shewa,Dano,99,5,53,157
Megabit,7th,2010,Oromia,Arsi,Limuna Bilbilo,84,86,37,207
Tir,5th,2009,Oromia,West Wellega,Begi Hospital,52,20,86,158
Sene,10th,2009,Oromia,East Hararge,Meta,75,54,54,183
Ginbot,9th,2009,Oromia,Buno Bedele,Chewaqa,35,17,83,135
Ginbot,9th,2011,Oromia,Horo Gudru Wellega,Abay Chomen,11,23,79,113
Hamle,11th,2009,Oromia,Bale,Gura Dhamole,72,23,25,120
Tir,5th,2009,Oromia,Arsi,Tiyo,48,40,37,125
Ginbot,9th,2010,Oromia,West Arsi,Arsi Negele Town,31,98,49,178
Sene,10th,2009,Oromia,West Arsi,Shashemene Rural,30,13,82,125
Ginbot,9th,2011,Oromia,Jimma,Shabe,73,12,7,92
Yekatit,6th,2011,Oromia,North Shewa,Kuyu Hospital,22,10,70,102
Hedar,3rd,2011,Oromia,West Shewa,Guder Hosp,35,68,83,186
Ginbot,9th,2010,Oromia,West Wellega,Yubdo,40,93,90,223
Nehase,12th,2009,Oromia,Horo Gudru Wellega,Hababo Guduru,27,49,1,77
Meskerem,1st,2010,Oromia,East Wellega,Haro Limu,99,48,71,218
Hedar,3rd,2010,Oromia,Ilu Aba Bora,Becho,30,64,90,184
Yekatit,6th,2011,Oromia,Buno Bedele,Meko,77,0,25,102
Yekatit,6th,2009,Oromia,Shashamane Town,Shashamane Town,51,36,97,184
Ginbot,9th,2009,Oromia,East Hararge,Kumbi,39,31,62,132
Megabit,7th,2009,Oromia,East Hararge,Deder Hospital,29,16,41,86
Meskerem,1st,2010,Oromia,Qeleme Wellega,Anfilo,93,25,23,141
Ginbot,9th,2009,Oromia,East Hararge,Chinakesen,36,12,90,138
Hedar,3rd,2010,Oromia,East Wellega,Diga,7,25,33,65
Meskerem,1st,2010,Oromia,Ilu Aba Bora,Bure,13,65,71,149
Miyazia,8th,2010,Oromia,West Shewa,Ambo Hospital,76,53,2,131
Nehase,12th,2009,Oromia,West Wellega,Genji,27,77,31,135
Tir,5th,2011,Oromia,Modjo Town,Modjo Town,28,37,72,137
Megabit,7th,2011,Oromia,Arsi,Robe,49,86,55,190
Meskerem,1st,2010,Oromia,West Shewa,Meta Waliqite,16,1,0,17
Tahesas,4th,2011,Oromia,Horo Gudru Wellega,Shambu Town,75,24,98,197
Teqemt,2nd,2011,Oromia,Bale,Goba Town,61,99,11,171
Hedar,3rd,2010,Oromia,West Shewa,Ejersa Lafo,7,31,79,117
Hamle,11th,2010,Oromia,South West Shewa,Becho,49,5,88,142
Hedar,3rd,2011,Oromia,Guji,Hambela Wamena,78,59,90,227
Miyazia,8th,2010,Oromia,Horo Gudru Wellega,Horo,20,95,10,125
Megabit,7th,2010,Oromia,West Hararge,Burka Dimtu,16,28,63,107
Miyazia,8th,2009,Oromia,Borena,Wachile,91,41,20,152
Tir,5th,2011,Oromia,South West Shewa,Tole,39,0,2,41
Miyazia,8th,2010,Oromia,Arsi,Tena,57,31,97,185
Nehase,12th,2009,Oromia,East Hararge,Haromaya Rural,40,9,99,148
Hedar,3rd,2011,Oromia,West Shewa,Ejersa Lafo,92,3,47,142
Tir,5th,2011,Oromia,Arsi,Ludehetosa,6,34,28,68
Teqemt,2nd,2010,Oromia,South West Shewa,Ilu,22,58,89,169
Megabit,7th,2010,Oromia,West Shewa,Tibe Kutaye,80,89,12,181
Hamle,11th,2009,Oromia,West Guji,Gelana,8,6,21,35
Teqemt,2nd,2010,Oromia,West Wellega,Begi,74,8,67,149
Sene,10th,2009,Oromia,West Hararge,Chiro Hospital,5,47,40,92
Nehase,12th,2010,Oromia,West Wellega,Lalo Asabi,94,31,88,213
Ginbot,9th,2010,Oromia,Ilu Aba Bora,Algesachi,68,61,19,148
Sene,10th,2009,Oromia,Guji,Bore,94,91,35,220
Nehase,12th,2010,Oromia,Horo Gudru Wellega,Jarte Jardga,18,14,89,121
Hamle,11th,2010,Oromia,West Wellega,Guliso,42,90,73,205
Teqemt,2nd,2010,Oromia,West Hararge,Daro Lebu,80,87,72,239
Yekatit,6th,2010,Oromia,East Hararge,Meyu Muleke,42,53,1,96
Megabit,7th,2010,Oromia,West Hararge,Chiro Zuriya,10,28,14,52
Ginbot,9th,2011,Oromia,Buno Bedele,Chewaqa,33,15,66,114
Tir,5th,2010,Oromia,East Hararge,Haromaya Rural,39,3,23,65
Yekatit,6th,2009,Oromia,West Hararge,Mesela,67,5,95,167
Hamle,11th,2009,Oromia,Ilu Aba Bora,Bilonopa,95,44,23,162
Tahesas,4th,2011,Oromia,Buno Bedele,Meko,35,78,11,124
Yekatit,6th,2009,Oromia,Bale,Agarfa,80,22,96,198
Teqemt,2nd,2010,Oromia,Borena,Dire,0,81,82,163
Ginbot,9th,2010,Oromia,Arsi,Zeway Dugda,44,88,94,226
Miyazia,8th,2009,Oromia,West Shewa,Dendi,47,4,32,83
Tir,5th,2009,Oromia,East Hararge,Deder,49,71,80,200
Tir,5th,2010,Oromia,Jimma,Limu Seka,47,57,22,126
Sene,10th,2009,Oromia,West Shewa,Abuna Gindeberet,74,53,85,212
Sene,10th,2009,Oromia,Arsi,Amigna,47,7,87,141
Tahesas,4th,2010,Oromia,Holeta Town,Holeta Town,17,11,66,94
Miyazia,8th,2009,Oromia,Bale,Raitu,1,29,68,98
Ginbot,9th,2011,Oromia,East Hararge,Aweday Town,62,57,67,186
Sene,10th,2009,Oromia,Buno Bedele,Meko,54,41,74,169
Yekatit,6th,2009,Oromia,East Shewa,Lomme,44,98,7,149
Teqemt,2nd,2011,Oromia,West Shewa,Codi,42,19,16,77
Hedar,3rd,2011,Oromia,Arsi,Deksis,19,65,13,97
Tahesas,4th,2010,Oromia,West Hararge,Chiro Town,61,3,80,144
Meskerem,1st,2011,Oromia,Jimma,Agaro,99,31,19,149
Megabit,7th,2010,Oromia,East Hararge,Jarso,8,29,39,76
Hamle,11th,2010,Oromia,Ilu Aba Bora,Darimu,12,45,57,114
Meskerem,1st,2011,Oromia,West Hararge,Chiro Hospital,58,18,88,164
Ginbot,9th,2011,Oromia,West Wellega,Jarso,53,15,51,119
Nehase,12th,2009,Oromia,West Shewa,Metarobi,66,99,63,228
Megabit,7th,2010,Oromia,West Shewa,Jibat,28,53,62,143
Tahesas,4th,2010,Oromia,Guji,Adola Town,41,60,95,196
Miyazia,8th,2011,Oromia,Bale,Legehida,71,60,10,141
Nehase,12th,2010,Oromia,North Shewa,Wuchale,27,6,42,75
Teqemt,2nd,2010,Oromia,West Arsi,Kore,16,86,45,147
Sene,10th,2010,Oromia,West Hararge,Bedesa Town,71,98,6,175
Nehase,12th,2009,Oromia,West Arsi,Dodola Town,69,68,82,219
Tir,5th,2011,Oromia,West Arsi,Dodola Town,70,38,93,201
Megabit,7th,2009,Oromia,Borena,Dire,86,43,43,172
Tahesas,4th,2011,Oromia,Guji,Aga Wayyu,21,32,45,98
Teqemt,2nd,2010,Oromia,Modjo Town,Modjo Town,31,26,1,58
Megabit,7th,2010,Oromia,Borena,Moyale,70,82,30,182
Hedar,3rd,2011,Oromia,West Wellega,Boji Dermeji,50,61,96,207
Nehase,12th,2010,Oromia,Horo Gudru Wellega,Horro Buluk,10,21,74,105
Tir,5th,2010,Oromia,Qeleme Wellega,Sedan Chanka,34,60,90,184
Meskerem,1st,2011,Oromia,West Wellega,Begi,22,31,26,79
Yekatit,6th,2010,Oromia,Guji,Uraga,43,46,98,187
Sene,10th,2011,Oromia,East Hararge,Deder Hospital,73,60,34,167
Teqemt,2nd,2011,Oromia,West Shewa,Gojo Hospital,63,10,82,155
Tahesas,4th,2010,Oromia,Nekemte Town,Nekemte Town,77,18,22,117
Hamle,11th,2010,Oromia,Qeleme Wellega,Laloqile,20,75,84,179
Sene,10th,2011,Oromia,East Hararge,Babile,50,4,68,122
Teqemt,2nd,2011,Oromia,East Hararge,Goro Muti,66,78,62,206
Nehase,12th,2010,Oromia,Bale,Gura Dhamole,94,43,99,236
Hamle,11th,2009,Oromia,Horo Gudru Wellega,Amuru,24,96,48,168
Megabit,7th,2011,Oromia,Horo Gudru Wellega,Amuru,19,9,82,110
Tahesas,4th,2010,Oromia,West Guji,Kercha,55,57,96,208
Yekatit,6th,2009,Oromia,Guji,Anna Sora,35,55,6,96
Sene,10th,2009,Oromia,Guji,Dima,41,99,58,198
Hedar,3rd,2010,Oromia,Borena,Dhas,15,45,10,70
Hamle,11th,2010,Oromia,West Arsi,Adaba,22,88,4,114
Sene,10th,2011,Oromia,West Hararge,Oda Bultum,79,74,82,235
Hamle,11th,2010,Oromia,East Wellega,Limu,19,89,91,199
Nehase,12th,2010,Oromia,East Wellega,Boneya Bushe,10,38,27,75
Teqemt,2nd,2010,Oromia,Ilu Aba Bora,Darimu,66,34,4,104
Tir,5th,2011,Oromia,Guji,Saba Boru,24,22,45,91
Hamle,11th,2009,Oromia,Horo Gudru Wellega,Hababo Guduru,45,33,66,144
Meskerem,1st,2010,Oromia,East Wellega,Haro Limu,82,50,79,211
Yekatit,6th,2011,Oromia,Arsi,Sire,4,1,60,65
Tir,5th,2011,Oromia,West Arsi,Loke Hada Hospital,6,25,59,90
Megabit,7th,2010,Oromia,West Arsi,Arsi Negele Town,19,90,28,137
Tahesas,4th,2010,Oromia,South West Shewa,Sodo Dac'Ha,48,43,48,139
Tir,5th,2011,Oromia,East Hararge,Fedis,76,66,86,228
Ginbot,9th,2010,Oromia,Bale,Delo Mena,3,39,70,112
Sene,10th,2010,Oromia,East Hararge,Deder Hospital,67,92,77,236
Teqemt,2nd,2010,Oromia,Bishoftu Town,Bishoftu Town,54,6,71,131
Miyazia,8th,2010,Oromia,West Shewa,Ejerie,37,62,27,126
Megabit,7th,2009,Oromia,East Hararge,Midega Tole,55,60,10,125
Hedar,3rd,2010,Oromia,West Hararge,Gelemso Hospital,3,65,71,139
Megabit,7th,2010,Oromia,East Hararge,Gursum,62,29,92,183
Nehase,12th,2010,Oromia,Jimma,B/Tolyi,11,17,95,123
Miyazia,8th,2009,Oromia,Borena,Moyale,56,36,29,121
Miyazia,8th,2009,Oromia,East Wellega,Wayu Tuqa,86,25,69,180
Yekatit,6th,2010,Oromia,East Wellega,Limu,6,73,85,164
Nehase,12th,2010,Oromia,Jimma,Shabe,9,99,81,189
Tir,5th,2010,Oromia,West Shewa,Tikur Enchini,80,29,9,118
Sene,10th,2010,Oromia,West Wellega,Ayira Hospital,29,46,10,85
Sene,10th,2010,Oromia,South West Shewa,Tole,27,24,48,99
Ginbot,9th,2010,Oromia,Buno Bedele,Dedesa,49,90,79,218
Miyazia,8th,2010,Oromia,West Wellega,Mendi Hospital,99,10,19,128
Tahesas,4th,2010,Oromia,West Guji,Biebirsa Kojowa,58,67,4,129
Sene,10th,2011,Oromia,West Shewa,Ambo,75,81,27,183
Hedar,3rd,2010,Oromia,Shashamane Town,Shashamane Town,54,11,25,90
Tir,5th,2010,Oromia,North Shewa,Hidabu Abote,93,47,39,179
Sene,10th,2009,Oromia,Assela Town,Assela Town,89,50,48,187
Nehase,12th,2009,Oromia,West Wellega,Nejo Hospital,28,90,9,127
Ginbot,9th,2011,Oromia,East Hararge,Bedeno,83,67,57,207
Teqemt,2nd,2011,Oromia,East Wellega,Wayu Tuqa,35,3,46,84
Hedar,3rd,2011,Oromia,Horo Gudru Wellega,Gudru,10,7,74,91
Sene,10th,2009,Oromia,Arsi,Sire,92,20,29,141
Sene,10th,2009,Oromia,Burayu Town,Burayu Town,68,59,2,129
Meskerem,1st,2011,Oromia,West Wellega,Homa,69,54,29,152
Yekatit,6th,2009,Oromia,West Wellega,Yubdo,90,25,63,178
Megabit,7th,2010,Oromia,Horo Gudru Wellega,Horo,1,16,37,54
Tahesas,4th,2010,Oromia,North Shewa,Jido,47,55,7,109
Tir,5th,2010,Oromia,West Shewa,Ilu Galan,18,44,7,69
Ginbot,9th,2010,Oromia,Jimma,Omonada,42,13,54,109
Hamle,11th,2010,Oromia,West Hararge,Gelemso Hospital,55,97,0,152
Nehase,12th,2009,Oromia,West Wellega,Babo Gembel,67,78,11,156
Tir,5th,2010,Oromia,West Wellega,Yubdo,62,49,27,138
Sene,10th,2011,Oromia,Horo Gudru Wellega,Gudru,73,96,31,200
Tahesas,4th,2011,Oromia,Qeleme Wellega,Laloqile,20,24,36,80
Miyazia,8th,2011,Oromia,East Hararge,Haromaya Town,8,20,51,79
Tir,5th,2010,Oromia,Burayu Town,Burayu Town,33,67,98,198
Hamle,11th,2009,Oromia,Bale,Goba Town,43,95,41,179
Ginbot,9th,2010,Oromia,West Hararge,Hawi Gudina,18,46,19,83
Miyazia,8th,2009,Oromia,Adama Special Town,Adama Town,8,76,8,92
Sene,10th,2011,Oromia,Nekemte Town,Nekemte Town,10,36,21,67
Hedar,3rd,2010,Oromia,West Hararge,Chiro Hospital,17,77,82,176
Meskerem,1st,2010,Oromia,West Shewa,Tibe Kutaye,7,25,34,66
Yekatit,6th,2011,Oromia,Bale,Dawe Qachen,54,15,97,166
Miyazia,8th,2010,Oromia,West Wellega,Haru,27,3,42,72
Yekatit,6th,2010,Oromia,Qeleme Wellega,Dale Wabera,17,42,22,81
Nehase,12th,2010,Oromia,Arsi,Gololcha,47,91,88,226
Ginbot,9th,2011,Oromia,Ilu Aba Bora,Doreni,86,76,64,226
Megabit,7th,2011,Oromia,Jimma,Seka Chhokorsa Hospital,80,92,66,238
Meskerem,1st,2011,Oromia,Finfine Zuria,Sebeta Awas,53,23,60,136
Miyazia,8th,2011,Oromia,West Guji,Biebirsa Kojowa,28,28,86,142
Ginbot,9th,2009,Oromia,Arsi,Tiyo,75,26,27,128
Yekatit,6th,2009,Oromia,South West Shewa,Ilu,55,64,80,199
Hamle,11th,2009,Oromia,South West Shewa,St.Luke Hospital,66,27,37,130
Nehase,12th,2010,Oromia,West Guji,Abaya,94,61,12,167
Miyazia,8th,2010,Oromia,Buno Bedele,Gechi,9,38,94,141
Teqemt,2nd,2010,Oromia,Buno Bedele,Bedele Town,26,87,8,121
Ginbot,9th,2011,Oromia,East Hararge,Gursum,77,35,81,193
Yekatit,6th,2009,Oromia,Borena,Dire,55,11,57,123
Sene,10th,2010,Oromia,Horo Gudru Wellega,Horo,7,34,84,125
Megabit,7th,2011,Oromia,East Hararge,Meyu Muleke,2,37,88,127
Ginbot,9th,2009,Oromia,West Shewa,Metarobi,27,33,90,150
Ginbot,9th,2010,Oromia,Qeleme Wellega,Yemalogi Wolel,86,82,75,243
Tir,5th,2010,Oromia,East Hararge,Gursum,51,90,61,202
Tahesas,4th,2010,Oromia,Arsi,Bekoji Town,71,0,93,164
Nehase,12th,2009,Oromia,Guji,Uraga,15,55,3,73
Ginbot,9th,2011,Oromia,East Shewa,Adama,94,28,55,177
Tir,5th,2011,Oromia,West Hararge,Oda Bultum,99,95,85,279
Sene,10th,2011,Oromia,Arsi,Bale Gesgara,75,45,42,162
Hamle,11th,2010,Oromia,West Guji,Kercha,25,76,31,132
Miyazia,8th,2011,Oromia,Bale,Ginir Town,68,66,79,213
Tir,5th,2011,Oromia,East Shewa,Fentale,14,31,26,71
Yekatit,6th,2010,Oromia,Bale,Arena Buluq,13,80,91,184
Miyazia,8th,2010,Oromia,West Hararge,Chiro Zuriya,16,94,79,189
Teqemt,2nd,2010,Oromia,Dukem Town,Dukem Town,97,46,82,225
Sene,10th,2010,Oromia,West Hararge,Meiso,49,69,40,158
Megabit,7th,2009,Oromia,West Wellega,Yubdo,29,9,56,94
Sene,10th,2009,Oromia,Jimma,O/Beyam,83,50,31,164
Ginbot,9th,2011,Oromia,East Wellega,Diga,93,56,64,213
Ginbot,9th,2011,Oromia,South West Shewa,Ameya Hospital,21,84,64,169
Tahesas,4th,2010,Oromia,Borena,Yabelo Rural,49,24,68,141
Tahesas,4th,2010,Oromia,East Hararge,Kombolicha,4,95,33,132
Megabit,7th,2010,Oromia,Horo Gudru Wellega,Abay Chomen,77,68,24,169
Hamle,11th,2010,Oromia,South West Shewa,Tulu Bolo Hospital,87,54,34,175
Ginbot,9th,2009,Oromia,East Hararge,Meyu Muleke,91,41,89,221
Miyazia,8th,2010,Oromia,North Shewa,Abichugna,22,56,11,89
Nehase,12th,2010,Oromia,West Shewa,Elifata,1,53,17,71
Tir,5th,2010,Oromia,Guji,Liben,78,99,40,217
Tahesas,4th,2010,Oromia,South West Shewa,Ameya,43,32,95,170
Tir,5th,2009,Oromia,East Wellega,Kiremu,65,50,6,121
Teqemt,2nd,2010,Oromia,West Hararge,Hawi Gudina,37,41,26,104
Hedar,3rd,2010,Oromia,Horo Gudru Wellega,Abe Dengoro,70,87,23,180
Ginbot,9th,2010,Oromia,North Shewa,Yaya Gulele,23,86,26,135
Megabit,7th,2009,Oromia,West Wellega,Gimbi Adventist Hospital,88,32,97,217
Nehase,12th,2009,Oromia,Burayu Town,Burayu Town,86,11,74,171
Tahesas,4th,2010,Oromia,Bale,Legehida,86,76,16,178
Hedar,3rd,2011,Oromia,Horo Gudru Wellega,Gudru,42,59,44,145
Tir,5th,2011,Oromia,West Hararge,Burka Dimtu,33,40,76,149
Nehase,12th,2009,Oromia,West Wellega,Gimbi Adventist Hospital,41,63,58,162
Tir,5th,2010,Oromia,East Hararge,Babile Woreda,23,27,40,90
Tahesas,4th,2010,Oromia,Bale,Meda Welabu,11,86,72,169
Hedar,3rd,2010,Oromia,North Shewa,Aleiltu,10,75,66,151
Megabit,7th,2009,Oromia,Arsi,Chole,10,86,89,185
Megabit,7th,2010,Oromia,North Shewa,Kimbibit,17,62,93,172
Tahesas,4th,2011,Oromia,Jimma,B/Tolyi,12,21,28,61
Yekatit,6th,2010,Oromia,Arsi,Digeluna Tijo,86,14,89,189
Hedar,3rd,2010,Oromia,Jimma,Shabe,84,2,44,130
Tir,5th,2009,Oromia,Dukem Town,Dukem Town,13,80,66,159
Meskerem,1st,2011,Oromia,East Wellega,Wayu Tuqa,73,14,5,92
Nehase,12th,2010,Oromia,Sululta Town,Sululta Town,9,57,49,115
Meskerem,1st,2010,Oromia,West Wellega,Gimbi Adventist Hospital,85,91,58,234
Ginbot,9th,2009,Oromia,Ilu Aba Bora,Becho,58,71,80,209
Teqemt,2nd,2011,Oromia,West Wellega,Gimbi Adventist Hospital,97,54,30,181
Yekatit,6th,2009,Oromia,West Hararge,Hawi Gudina,39,61,92,192
Ginbot,9th,2011,Oromia,Jimma,Gera,38,56,65,159
Megabit,7th,2009,Oromia,East Shewa,Bora,37,68,46,151
Miyazia,8th,2009,Oromia,East Shewa,Olanciti Hospital,27,6,6,39
Tir,5th,2010,Oromia,Bale,Dawe Serar,80,44,99,223
Tir,5th,2010,Oromia,West Shewa,Midakegni,71,69,34,174
Teqemt,2nd,2010,Oromia,Adama Special Town,Adama Town,96,85,28,209
Hamle,11th,2009,Oromia,North Shewa,Jido,32,8,51,91
Nehase,12th,2010,Oromia,Borena,Yabelo Hospital,82,18,55,155
Sene,10th,2011,Oromia,North Shewa,Kuyu Hospital,98,7,11,116
Hedar,3rd,2010,Oromia,West Guji,Bule Hora Hospital,59,41,83,183
Teqemt,2nd,2011,Oromia,North Shewa,Wuchale,16,26,98,140
Ginbot,9th,2010,Oromia,West Hararge,Oda Bultum,8,55,20,83
Miyazia,8th,2011,Oromia,Guji,Anna Sora,3,18,34,55
Meskerem,1st,2011,Oromia,Borena,El Way,90,52,10,152
Yekatit,6th,2011,Oromia,Horo Gudru Wellega,Shambu Hospital,53,58,34,145
Megabit,7th,2010,Oromia,East Wellega,Kiremu,17,2,57,76
Megabit,7th,2010,Oromia,Borena,Arero,22,22,85,129
Megabit,7th,2011,Oromia,Bale,Seweyna,53,6,33,92
Miyazia,8th,2009,Oromia,Jimma,Dedo,96,36,67,199
Hamle,11th,2010,Oromia,North Shewa,Kuyu,10,42,7,59
Yekatit,6th,2011,Oromia,West Shewa,Ejerie,23,27,69,119
Meskerem,1st,2010,Oromia,West Hararge,West Harerge	Gumbi Bordede,26,50,77,153
Nehase,12th,2010,Oromia,Bale,Gasera,77,90,82,249
Tir,5th,2011,Oromia,Arsi,Hitosa,14,23,58,95
Meskerem,1st,2010,Oromia,East Wellega,Limu,73,6,26,105
Teqemt,2nd,2010,Oromia,Horo Gudru Wellega,Horo,1,46,29,76
Ginbot,9th,2009,Oromia,South West Shewa,Goro,75,47,20,142
Hedar,3rd,2011,Oromia,West Hararge,Chiro Town,61,63,74,198
Meskerem,1st,2011,Oromia,Arsi,Amigna,84,95,59,238
Sene,10th,2010,Oromia,Guji,Hambela Wamena,63,71,2,136
Tir,5th,2009,Oromia,South West Shewa,Woliso Town,49,50,46,145
Tir,5th,2009,Oromia,East Hararge,Chinakesen,62,16,22,100
Meskerem,1st,2011,Oromia,Qeleme Wellega,Hawa Gelan,49,50,57,156
Megabit,7th,2011,Oromia,West Wellega,Homa,58,71,84,213
Ginbot,9th,2010,Oromia,Arsi,Tiyo,86,85,29,200
Megabit,7th,2010,Oromia,East Hararge,Deder,97,20,72,189
Sene,10th,2009,Oromia,East Wellega,Gida Ayana,12,14,87,113
Meskerem,1st,2010,Oromia,West Shewa,Abuna Gindeberet,69,35,9,113
Megabit,7th,2010,Oromia,West Shewa,Ambo,13,17,6,36
Ginbot,9th,2010,Oromia,Buno Bedele,Chewaqa,78,78,46,202
Ginbot,9th,2011,Oromia,Borena,El Way,13,25,24,62
Teqemt,2nd,2010,Oromia,Ilu Aba Bora,Bure,82,3,20,105
Hamle,11th,2009,Oromia,East Shewa,Mojo,42,96,87,225
Yekatit,6th,2010,Oromia,Qeleme Wellega,Hawa Gelan,74,32,63,169
Meskerem,1st,2010,Oromia,Finfine Zuria,Mullo,3,40,65,108
Sene,10th,2009,Oromia,Guji,Shakiso Town,67,70,30,167
Nehase,12th,2010,Oromia,East Hararge,Haromaya Rural,72,83,81,236
Tahesas,4th,2010,Oromia,East Wellega,Boneya Bushe,46,95,1,142
Teqemt,2nd,2010,Oromia,West Shewa,Midakegni,76,16,59,151
Tahesas,4th,2011,Oromia,West Guji,Mkelka Soda,7,20,1,28
Tir,5th,2009,Oromia,Borena,Arero,91,79,75,245
Teqemt,2nd,2011,Oromia,East Wellega,Guto Gida,55,92,48,195
Miyazia,8th,2010,Oromia,West Hararge,Chiro Zuriya,94,39,15,148
Meskerem,1st,2011,Oromia,Guji,Adola Town,65,33,60,158
Tir,5th,2011,Oromia,West Shewa,Jeldu,6,90,62,158
Miyazia,8th,2011,Oromia,Jimma,Agaro Hospital,8,17,84,109
Tahesas,4th,2010,Oromia,East Hararge,Deder,10,29,20,59
Nehase,12th,2009,Oromia,West Wellega,Mendi Hospital,24,64,53,141
Miyazia,8th,2010,Oromia,West Shewa,Ambo,72,28,28,128
Megabit,7th,2009,Oromia,West Shewa,Midakegni,81,1,96,178
Yekatit,6th,2010,Oromia,Buno Bedele,Diga,70,29,63,162
Meskerem,1st,2010,Oromia,West Arsi,Bishan Guracha Town,0,51,4,55
Sene,10th,2010,Oromia,West Guji,Abaya,87,17,92,196
Yekatit,6th,2009,Oromia,West Guji,Biebirsa Kojowa,44,2,73,119
Megabit,7th,2010,Oromia,Arsi,Tiyo,64,87,52,203
Sene,10th,2011,Oromia,West Hararge,Hawi Gudina,65,43,20,128
Meskerem,1st,2011,Oromia,Horo Gudru Wellega,Hababo Guduru,41,99,84,224
Yekatit,6th,2009,Oromia,West Wellega,Yubdo,92,97,68,257
Teqemt,2nd,2010,Oromia,Bale,Legehida,69,14,28,111
Hedar,3rd,2011,Oromia,West Arsi,Wondo,86,97,44,227
Ginbot,9th,2011,Oromia,Buno Bedele,Dedesa,36,90,46,172
Ginbot,9th,2011,Oromia,North Shewa,Dera,31,65,75,171
Megabit,7th,2010,Oromia,Borena,Moyale Hospital,62,41,22,125
Miyazia,8th,2011,Oromia,Assela Town,Assela Town,40,87,6,133
Tahesas,4th,2011,Oromia,West Shewa,Tibe Kutaye,73,24,0,97
Miyazia,8th,2011,Oromia,Buno Bedele,Chora,12,30,87,129
Yekatit,6th,2009,Oromia,East Hararge,Bedeno,78,58,76,212
Nehase,12th,2010,Oromia,East Hararge,Kurfa Chele,15,59,22,96
Tir,5th,2009,Oromia,Bale,Delo Mena,52,83,54,189
Hamle,11th,2010,Oromia,South West Shewa,Ameya,30,23,89,142
Teqemt,2nd,2010,Oromia,West Arsi,Hebal Arsi,95,5,85,185
Meskerem,1st,2011,Oromia,Guji,Shakiso Town,7,48,79,134
Meskerem,1st,2011,Oromia,Bale,Seweyna,70,95,6,171
Yekatit,6th,2011,Oromia,Arsi,Robe,93,88,63,244
Sene,10th,2010,Oromia,Guji,Bore,46,21,37,104
Nehase,12th,2010,Oromia,Jimma,Guma,23,23,79,125
Yekatit,6th,2011,Oromia,Bale,Agarfa,96,59,49,204
Ginbot,9th,2011,Oromia,Guji,Shakiso Town,1,9,80,90
Nehase,12th,2010,Oromia,West Hararge,Habro,32,45,59,136
Teqemt,2nd,2011,Oromia,Arsi,Sire,3,66,47,116
Sene,10th,2011,Oromia,West Arsi,Nensebo,5,11,37,53
Ginbot,9th,2010,Oromia,East Hararge,Deder,35,89,92,216
Meskerem,1st,2010,Oromia,West Wellega,Boji Cheqorsa,46,62,19,127
Ginbot,9th,2009,Oromia,East Wellega,Diga,62,61,86,209
Hedar,3rd,2011,Oromia,Jimma,Gera,94,63,48,205
Miyazia,8th,2010,Oromia,Guji,Negele Town,42,70,17,129
Nehase,12th,2010,Oromia,Bale,Arena Buluq,64,90,75,229
Tahesas,4th,2010,Oromia,Buno Bedele,Dapho Hana,58,34,2,94
Megabit,7th,2011,Oromia,South West Shewa,Tulu Bolo Hospital,6,55,15,76
Hedar,3rd,2011,Oromia,West Shewa,Codi,79,71,74,224
Miyazia,8th,2011,Oromia,Sebeta Town,Sebeta Town,62,96,89,247
Miyazia,8th,2009,Oromia,Bale,Robe Town,54,57,24,135
Megabit,7th,2010,Oromia,West Shewa,Adea Berga,51,22,88,161
Megabit,7th,2009,Oromia,East Wellega,Gida Ayana,92,82,37,211
Megabit,7th,2010,Oromia,Bale,Goro,95,90,12,197
Megabit,7th,2010,Oromia,East Wellega,Gobu Seyo,6,1,56,63
Yekatit,6th,2009,Oromia,Guji,Adola Town,3,87,86,176
Yekatit,6th,2010,Oromia,West Wellega,Jarso,71,13,66,150
Tir,5th,2011,Oromia,Qeleme Wellega,Anfilo,76,65,43,184
Teqemt,2nd,2010,Oromia,Jimma,Mana,60,33,54,147
Hedar,3rd,2011,Oromia,West Arsi,Kofele,40,7,88,135
Hedar,3rd,2011,Oromia,West Wellega,Begi Hospital,52,41,20,113
Teqemt,2nd,2010,Oromia,West Guji,Bule Hora,94,3,77,174
Sene,10th,2009,Oromia,Horo Gudru Wellega,Jima Rare,36,92,31,159
Ginbot,9th,2009,Oromia,Borena,Dilo,3,39,61,103
Tir,5th,2009,Oromia,Arsi,Guna,76,28,55,159
Meskerem,1st,2011,Oromia,Guji,Negele Hospital,22,81,44,147
Yekatit,6th,2009,Oromia,West Guji,Mkelka Soda,72,97,49,218
Tir,5th,2010,Oromia,Jimma,Seka Chekorsa,78,95,30,203
Tir,5th,2011,Oromia,Jimma,B/Tolyi,93,37,61,191
Sene,10th,2010,Oromia,Jimma,Setema Hospital,27,26,95,148
Ginbot,9th,2011,Oromia,Qeleme Wellega,Gidami Hosp,27,54,82,163
Megabit,7th,2009,Oromia,Guji,Adola Reda,91,57,15,163
Miyazia,8th,2011,Oromia,South West Shewa,Ilu,7,83,27,117
Teqemt,2nd,2011,Oromia,Buno Bedele,Chora,26,24,85,135
Hamle,11th,2010,Oromia,West Shewa,Dendi,54,7,2,63
Hamle,11th,2009,Oromia,Bale,Gasera,37,48,74,159
Nehase,12th,2010,Oromia,West Shewa,Metarobi,93,79,7,179
Ginbot,9th,2011,Oromia,Borena,Arero,42,45,1,88
Teqemt,2nd,2011,Oromia,West Hararge,Chiro Zuriya,13,48,28,89
Meskerem,1st,2010,Oromia,East Wellega,Guto Gida,36,35,18,89
Tir,5th,2011,Oromia,West Arsi,Bishan Guracha Town,56,7,2,65
Hamle,11th,2010,Oromia,West Shewa,Abuna Gindeberet,66,39,92,197
Miyazia,8th,2009,Oromia,West Hararge,Chiro Zuriya,91,63,42,196
Hedar,3rd,2011,Oromia,East Wellega,Nunu Qumba,61,25,30,116
Miyazia,8th,2010,Oromia,East Wellega,Wayu Tuqa,96,24,60,180
Tir,5th,2010,Oromia,West Shewa,Ilu Galan,62,94,9,165
Tir,5th,2009,Oromia,East Wellega,Jimma Arjo,88,24,72,184
Megabit,7th,2011,Oromia,Finfine Zuria,Mullo,75,79,17,171
Sene,10th,2011,Oromia,Guji,Odo Shakiso,96,28,95,219
Hedar,3rd,2011,Oromia,West Hararge,Chiro Town,10,70,68,148
Yekatit,6th,2010,Oromia,South West Shewa,Kersana Malima,35,91,17,143
Yekatit,6th,2009,Oromia,West Wellega,Mendi Hospital,76,17,1,94
Miyazia,8th,2010,Oromia,West Guji,Bule Hora,91,89,80,260
Tahesas,4th,2011,Oromia,East Shewa,Lomme,17,33,28,78
Miyazia,8th,2011,Oromia,West Wellega,Gimbi,42,23,94,159
Miyazia,8th,2009,Oromia,Buno Bedele,Chora,94,37,7,138
Sene,10th,2009,Oromia,West Guji,Biebirsa Kojowa,27,49,53,129
Teqemt,2nd,2011,Oromia,East Hararge,Chelenko Hospital,82,25,25,132
Yekatit,6th,2010,Oromia,Bale,Ginir,94,43,39,176
Hedar,3rd,2010,Oromia,East Wellega,Wama Hagelo,24,34,7,65
Nehase,12th,2010,Oromia,Arsi,Robe,75,13,49,137
Meskerem,1st,2010,Oromia,Guji,Adola Town,29,39,61,129
Ginbot,9th,2009,Oromia,Buno Bedele,Diga,81,67,26,174
Tahesas,4th,2011,Oromia,Jimma,Gera,39,47,40,126
Teqemt,2nd,2010,Oromia,West Hararge,Anchar,14,14,67,95
Megabit,7th,2010,Oromia,Arsi,Gololcha,80,57,88,225
Sene,10th,2009,Oromia,West Shewa,Codi,22,3,49,74
Ginbot,9th,2009,Oromia,South West Shewa,Goro,19,78,40,137
Megabit,7th,2009,Oromia,South West Shewa,Seden Sodo,59,15,82,156
Megabit,7th,2009,Oromia,West Hararge,Chiro Town,95,30,19,144
Tahesas,4th,2011,Oromia,Qeleme Wellega,Hawa Gelan Hosp,13,72,9,94
Tahesas,4th,2011,Oromia,Guji,Bore Hospital,5,22,26,53
Yekatit,6th,2010,Oromia,East Hararge,Gole Oda,91,94,57,242
Yekatit,6th,2009,Oromia,West Guji,Bule Hora Hospital,8,46,0,54
Tir,5th,2011,Oromia,Jimma,Setema Hospital,17,76,39,132
Tahesas,4th,2010,Oromia,West Shewa,Ambo Hospital,86,76,84,246
Hedar,3rd,2010,Oromia,West Wellega,Mendi Hospital,25,87,67,179
Teqemt,2nd,2011,Oromia,Ilu Aba Bora,Becho,80,64,8,152
Ginbot,9th,2011,Oromia,West Arsi,Loke Hada Hospital,82,86,66,234
Sene,10th,2011,Oromia,Guji,Saba Boru,31,17,96,144
Tir,5th,2011,Oromia,Jimma,Shabe,8,72,29,109
Meskerem,1st,2010,Oromia,Finfine Zuria,Sululta Town,60,2,45,107
Teqemt,2nd,2011,Oromia,West Wellega,Mene Sibu,58,67,94,219
Hamle,11th,2009,Oromia,West Wellega,Guliso,20,17,94,131
Hamle,11th,2010,Oromia,West Wellega,Nejo Hospital,83,35,27,145
Ginbot,9th,2009,Oromia,East Hararge,Deder,42,97,94,233
Megabit,7th,2010,Oromia,West Shewa,Dano,19,93,18,130
Sene,10th,2009,Oromia,Guji,Anna Sora,91,87,18,196
Ginbot,9th,2011,Oromia,Guji,Odo Shakiso,80,31,24,135
Meskerem,1st,2010,Oromia,Guji,Gumi Eldallo,57,76,94,227
Miyazia,8th,2011,Oromia,Arsi,Chole,7,35,92,134
Teqemt,2nd,2010,Oromia,Horo Gudru Wellega,Jima Geneti,32,89,54,175
Tir,5th,2009,Oromia,West Wellega,Genji,96,20,41,157
Yekatit,6th,2011,Oromia,Guji,Liben,89,95,82,266
Meskerem,1st,2011,Oromia,East Wellega,Sasiga,45,41,3,89
Hedar,3rd,2011,Oromia,West Wellega,Nole Kaba,74,31,12,117
Teqemt,2nd,2011,Oromia,Arsi,Sude,77,43,96,216
Miyazia,8th,2010,Oromia,West Hararge,Doba,50,27,3,80
Teqemt,2nd,2011,Oromia,Borena,Dilo,9,77,38,124
Yekatit,6th,2010,Oromia,South West Shewa,Dawo,58,0,71,129
Megabit,7th,2010,Oromia,Bale,Dawe Qachen,2,21,44,67
Hedar,3rd,2011,Oromia,East Wellega,Haro Limu,76,92,45,213
Yekatit,6th,2009,Oromia,Finfine Zuria,Holeta,15,56,12,83
Sene,10th,2009,Oromia,West Guji,Bule Hora Hospital,86,54,24,164
Teqemt,2nd,2011,Oromia,North Shewa,Kuyu,54,85,6,145
Megabit,7th,2010,Oromia,East Wellega,Gudeyabila,61,33,20,114
Megabit,7th,2009,Oromia,West Hararge,Bedesa Town,52,30,62,144
Megabit,7th,2009,Oromia,Guji,Shakiso Town,76,43,0,119
Megabit,7th,2009,Oromia,North Shewa,Kuyu,58,85,0,143
Nehase,12th,2009,Oromia,Bale,Goro,78,98,32,208
Yekatit,6th,2011,Oromia,East Wellega,Haro Limu,17,21,17,55
Hedar,3rd,2011,Oromia,North Shewa,Yaya Gulele,29,80,12,121
Ginbot,9th,2010,Oromia,Borena,Gomole,80,31,49,160
Megabit,7th,2010,Oromia,Bale,Berbere,29,29,92,150
Yekatit,6th,2010,Oromia,West Shewa,Codi,1,47,16,64
Megabit,7th,2010,Oromia,South West Shewa,Ameya Hospital,72,65,74,211
Sene,10th,2009,Oromia,West Shewa,Ginde Beret,21,54,31,106
Hedar,3rd,2011,Oromia,Guji,Odo Shakiso,20,52,60,132
Miyazia,8th,2010,Oromia,East Hararge,Aweday Town,85,52,15,152
Megabit,7th,2011,Oromia,East Wellega,Ebantu,29,22,98,149
Meskerem,1st,2010,Oromia,Finfine Zuria,Walmera,83,61,40,184
Megabit,7th,2011,Oromia,Qeleme Wellega,Dale Sedi,97,4,11,112
Yekatit,6th,2011,Oromia,South West Shewa,St.Luke Hospital,79,56,35,170
Sene,10th,2010,Oromia,West Guji,Suro Barguda,98,69,16,183
Meskerem,1st,2011,Oromia,South West Shewa,Ameya,7,40,66,113
Yekatit,6th,2011,Oromia,West Shewa,Ginde Beret,21,20,77,118
Ginbot,9th,2009,Oromia,East Wellega,Ebantu,0,27,71,98
Miyazia,8th,2009,Oromia,East Hararge,Kumbi,93,99,85,277
Sene,10th,2009,Oromia,East Shewa,Adama,63,79,41,183
Hamle,11th,2009,Oromia,Finfine Zuria,Sandefa,25,39,7,71
Nehase,12th,2009,Oromia,Bale,Dawe Serar,60,12,59,131
Megabit,7th,2011,Oromia,East Wellega,Limu,53,18,36,107
Teqemt,2nd,2011,Oromia,West Shewa,Bako Hospital,50,50,37,137
Miyazia,8th,2010,Oromia,Arsi,Shenan Kolu,57,10,28,95
Yekatit,6th,2010,Oromia,East Hararge,Babile,44,46,72,162
Megabit,7th,2011,Oromia,West Shewa,Ilu Galan,52,29,32,113
Megabit,7th,2011,Oromia,East Hararge,Fedis,68,29,42,139
Ginbot,9th,2011,Oromia,Ilu Aba Bora,Hurumu,74,76,20,170
Megabit,7th,2009,Oromia,West Shewa,Nono,20,30,33,83
Tir,5th,2009,Oromia,West Wellega,Jarso,53,48,58,159
Tir,5th,2009,Oromia,Borena,Dubluk,19,6,55,80
Nehase,12th,2009,Oromia,East Wellega,Wama Hagelo,91,18,93,202
Miyazia,8th,2009,Oromia,South West Shewa,Tulu Bolo Hospital,95,79,84,258
Tir,5th,2009,Oromia,West Wellega,Babo Gembel,4,60,0,64
Hedar,3rd,2010,Oromia,Borena,Dire,93,82,52,227
Megabit,7th,2010,Oromia,West Arsi,Shala,49,25,30,104
Yekatit,6th,2009,Oromia,Finfine Zuria,Berreh,98,91,38,227
Hamle,11th,2009,Oromia,Borena,Meyo,69,37,25,131
Miyazia,8th,2010,Oromia,Buno Bedele,Meko,78,6,1,85
Teqemt,2nd,2011,Oromia,East Hararge,Midega Tole,37,98,42,177
Megabit,7th,2009,Oromia,East Wellega,Guto Gida,23,64,62,149
Tahesas,4th,2011,Oromia,Borena,Wachile,75,57,74,206
Ginbot,9th,2010,Oromia,Horo Gudru Wellega,Horo,20,23,89,132
Sene,10th,2010,Oromia,West Hararge,Gemechis,61,49,67,177
Ginbot,9th,2011,Oromia,Arsi,Limuna Bilbilo,13,30,53,96
Megabit,7th,2010,Oromia,West Arsi,Kore,99,19,42,160
Hamle,11th,2010,Oromia,East Hararge,Kombolicha,66,17,90,173
Hamle,11th,2010,Oromia,East Wellega,Jimma Arjo,52,12,78,142
Tir,5th,2010,Oromia,West Shewa,Inchini Hospital,78,6,27,111
Megabit,7th,2009,Oromia,Borena,Dubluk,83,9,77,169
Yekatit,6th,2011,Oromia,Guji,Odo Shakiso,91,70,36,197
Nehase,12th,2009,Oromia,Borena,Gomole,38,16,13,67
Nehase,12th,2009,Oromia,Jimma,Gera,22,27,29,78
Hamle,11th,2010,Oromia,South West Shewa,Sodo Dac'Ha,81,43,3,127
Meskerem,1st,2010,Oromia,Bale,Gura Dhamole,22,61,14,97
Yekatit,6th,2010,Oromia,Horo Gudru Wellega,Abe Dengoro,4,7,61,72
Ginbot,9th,2009,Oromia,Guji,Odo Shakiso,29,75,23,127
Miyazia,8th,2011,Oromia,West Arsi,Wondo,26,10,31,67
Sene,10th,2009,Oromia,West Arsi,Wondo,84,51,61,196
Tahesas,4th,2010,Oromia,Guji,Aga Wayyu,11,36,9,56
Sene,10th,2009,Oromia,West Shewa,Tibe Kutaye,95,30,61,186
Nehase,12th,2010,Oromia,Ilu Aba Bora,Algesachi,34,49,96,179
Hamle,11th,2010,Oromia,Bale,Gura Dhamole,74,27,29,130
Meskerem,1st,2011,Oromia,Shashamane Town,Shashamane Town,71,29,40,140
Megabit,7th,2011,Oromia,Horo Gudru Wellega,Jarte Jardga,92,76,92,260
Hamle,11th,2009,Oromia,Qeleme Wellega,Yemalogi Wolel,72,13,35,120
Teqemt,2nd,2011,Oromia,East Wellega,Gobu Seyo,65,45,77,187
Megabit,7th,2009,Oromia,South West Shewa,Sodo Dac'Ha,33,20,76,129
Hamle,11th,2010,Oromia,North Shewa,Debre Libanos,72,47,82,201
Sene,10th,2009,Oromia,East Hararge,Haromaya Town,54,12,0,66
Sene,10th,2011,Oromia,Shashamane Town,Shashamane Town,21,99,89,209
Ginbot,9th,2010,Oromia,West Hararge,Gelemso Hospital,54,8,7,69
Meskerem,1st,2010,Oromia,West Arsi,Gambo Hospital,22,80,17,119
Teqemt,2nd,2011,Oromia,North Shewa,Abichugna,14,28,68,110
Miyazia,8th,2011,Oromia,East Wellega,Boneya Bushe,99,48,39,186
Megabit,7th,2010,Oromia,West Wellega,Lalo Asabi,85,19,88,192
Ginbot,9th,2010,Oromia,Borena,Meyo,65,74,78,217
Nehase,12th,2009,Oromia,East Hararge,Haromaya Town,96,12,37,145
Hedar,3rd,2011,Oromia,Qeleme Wellega,Dale Sedi,95,57,23,175
Hamle,11th,2010,Oromia,Arsi,Enkelo Wabe,6,16,13,35
Tir,5th,2010,Oromia,Guji,Negele Town,70,86,55,211
Yekatit,6th,2009,Oromia,East Hararge,Meyu Muleke,86,23,45,154
Nehase,12th,2009,Oromia,Qeleme Wellega,Dale Sedi,71,26,11,108
Megabit,7th,2011,Oromia,Horo Gudru Wellega,Horro Buluk,73,25,72,170
Tir,5th,2010,Oromia,West Wellega,Kundala,4,42,36,82
Miyazia,8th,2009,Oromia,West Shewa,Gedo Hospital,18,10,99,127
Teqemt,2nd,2011,Oromia,West Wellega,Boji Dermeji,19,45,95,159
Megabit,7th,2009,Oromia,East Hararge,Girawa,95,55,53,203
Sene,10th,2010,Oromia,West Arsi,Dodola Town,45,58,20,123
Nehase,12th,2010,Oromia,East Wellega,Sasiga,14,84,77,175
Ginbot,9th,2010,Oromia,Bale,Goba Town,14,91,2,107
Tahesas,4th,2010,Oromia,Horo Gudru Wellega,Abay Chomen,36,31,97,164
Megabit,7th,2009,Oromia,North Shewa,Yaya Gulele,42,9,79,130
Miyazia,8th,2010,Oromia,West Wellega,Nejo Town,20,83,67,170
Yekatit,6th,2009,Oromia,East Shewa,Bora,7,32,77,116
Meskerem,1st,2010,Oromia,North Shewa,Fiche Hospital,9,23,80,112
Hedar,3rd,2011,Oromia,Bale,Dinsho,73,12,12,97
Ginbot,9th,2010,Oromia,West Hararge,Daro Lebu,76,11,35,122
Miyazia,8th,2010,Oromia,West Wellega,Nejo Town,21,41,68,130
Miyazia,8th,2009,Oromia,East Shewa,Lomme,24,28,86,138
Miyazia,8th,2010,Oromia,North Shewa,Fichetown,94,98,28,220
Yekatit,6th,2009,Oromia,East Hararge,Babile,70,22,0,92
Ginbot,9th,2011,Oromia,Bale,Dawe Qachen,46,38,46,130
Teqemt,2nd,2010,Oromia,East Hararge,Kurfa Chele,81,64,49,194
Yekatit,6th,2011,Oromia,East Hararge,Meta,57,99,13,169
Tir,5th,2009,Oromia,West Arsi,Bishan Guracha Town,90,48,20,158
Teqemt,2nd,2010,Oromia,West Guji,Biebirsa Kojowa,22,34,41,97
Nehase,12th,2010,Oromia,Modjo Town,Modjo Town,22,56,43,121
Ginbot,9th,2010,Oromia,West Arsi,Shashemene Rural,60,33,14,107
Hedar,3rd,2010,Oromia,West Wellega,Yubdo,86,9,59,154
Sene,10th,2009,Oromia,East Wellega,Gudeyabila,19,92,58,169
Tir,5th,2009,Oromia,Jimma Spe Town,Jimma Spe Town,67,99,29,195
Meskerem,1st,2010,Oromia,West Hararge,Hawi Gudina,45,62,47,154
Hamle,11th,2009,Oromia,Bale,Sinana,42,98,2,142
Hedar,3rd,2010,Oromia,Jimma,Guma,84,19,12,115
Hedar,3rd,2010,Oromia,East Shewa,Dugda,95,21,36,152
Megabit,7th,2010,Oromia,South West Shewa,Seden Sodo,23,38,60,121
Megabit,7th,2009,Oromia,West Arsi,Gambo Hospital,37,37,90,164
Sene,10th,2010,Oromia,Jimma,Dedo,20,74,23,117
Sene,10th,2010,Oromia,Qeleme Wellega,Anfilo,74,16,93,183
Tahesas,4th,2010,Oromia,West Shewa,Ginde Beret,95,68,43,206
Miyazia,8th,2009,Oromia,South West Shewa,St.Luke Hospital,45,52,0,97
Megabit,7th,2010,Oromia,West Hararge,Daro Lebu,15,36,26,77
Ginbot,9th,2009,Oromia,Buno Bedele,Bedele Town,91,67,41,199
Nehase,12th,2010,Oromia,Borena,Yabelo,57,63,11,131
Hamle,11th,2010,Oromia,Guji,Negele Hospital,18,31,92,141
Teqemt,2nd,2011,Oromia,Nekemte Town,Nekemte Town,84,24,35,143
Ginbot,9th,2010,Oromia,North Shewa,Yaya Gulele,47,18,29,94
Hedar,3rd,2010,Oromia,Jimma,Setema,66,35,8,109
Miyazia,8th,2009,Oromia,Qeleme Wellega,Gawo Qebe,63,58,30,151
Tir,5th,2009,Oromia,West Guji,Suro Barguda,1,37,38,76
Ginbot,9th,2011,Oromia,Buno Bedele,Bedele Hospital,30,31,29,90
Nehase,12th,2009,Oromia,East Wellega,Gobu Seyo,24,39,13,76
Meskerem,1st,2011,Oromia,Bale,Raitu,55,76,92,223
Sene,10th,2011,Oromia,West Shewa,Bako Tibe,4,71,87,162
Tir,5th,2010,Oromia,North Shewa,Dera Hospital,57,42,2,101
Hamle,11th,2009,Oromia,West Shewa,Ginde Beret,73,2,48,123
Nehase,12th,2009,Oromia,Ilu Aba Bora,Hurumu,77,33,38,148
Nehase,12th,2010,Oromia,Burayu Town,Burayu Town,41,73,47,161
Megabit,7th,2010,Oromia,Qeleme Wellega,Sedan Chanka,68,92,22,182
Tir,5th,2010,Oromia,Arsi,Tena,66,23,35,124
Ginbot,9th,2011,Oromia,Qeleme Wellega,Dale Wabera,3,18,96,117
Nehase,12th,2010,Oromia,Finfine Zuria,Akaki,18,14,49,81
Tir,5th,2009,Oromia,Finfine Zuria,Sululta Town,21,41,42,104
Miyazia,8th,2011,Oromia,Arsi,Robe,64,22,51,137
Hedar,3rd,2010,Oromia,Buno Bedele,Gechi,3,82,61,146
Sene,10th,2011,Oromia,North Shewa,Fiche Hospital,76,49,75,200
Meskerem,1st,2011,Oromia,West Wellega,Seyo Nole,42,62,40,144
Tir,5th,2010,Oromia,West Wellega,Babo Gembel,93,73,63,229
Hedar,3rd,2010,Oromia,West Arsi,Wondo,17,73,7,97
Megabit,7th,2011,Oromia,West Arsi,Bishan Guracha Town,74,15,93,182
Hedar,3rd,2011,Oromia,Arsi,Shenan Kolu,46,36,48,130
Hamle,11th,2010,Oromia,Qeleme Wellega,Dambi Dollo,36,29,29,94
Miyazia,8th,2011,Oromia,Borena,Wachile,92,29,46,167
Hedar,3rd,2011,Oromia,Arsi,Merti,86,13,34,133
Meskerem,1st,2011,Oromia,South West Shewa,Kersana Malima,43,49,83,175
Tir,5th,2010,Oromia,Arsi,Munesa,78,39,85,202
Megabit,7th,2009,Oromia,West Shewa,Bako Tibe,77,71,21,169
Ginbot,9th,2010,Oromia,East Hararge,Babile Woreda,86,70,54,210
Nehase,12th,2009,Oromia,Buno Bedele,Chora,15,86,41,142
Meskerem,1st,2010,Oromia,North Shewa,Aleiltu,12,66,99,177
Tir,5th,2011,Oromia,East Hararge,Meyu Muleke,41,89,6,136
Meskerem,1st,2010,Oromia,Arsi,Enkelo Wabe,22,30,62,114
Sene,10th,2009,Oromia,Guji,Adola Town,42,74,61,177
Tir,5th,2009,Oromia,North Shewa,Kuyu,2,17,74,93
Ginbot,9th,2011,Oromia,Borena,Dilo,52,39,57,148
Hedar,3rd,2011,Oromia,Ilu Aba Bora,Becho,29,30,86,145
Sene,10th,2009,Oromia,Arsi,Gololcha,90,77,82,249
Miyazia,8th,2011,Oromia,West Wellega,Ayira Hospital,36,45,71,152
Miyazia,8th,2010,Oromia,Borena,Dhas,72,12,52,136
Hamle,11th,2009,Oromia,East Wellega,Sibu Sire,16,90,97,203
Ginbot,9th,2011,Oromia,Horo Gudru Wellega,Shambu Town,27,16,19,62
Hamle,11th,2009,Oromia,Guji,Gumi Eldallo,74,3,5,82
Yekatit,6th,2010,Oromia,West Shewa,Ejerie,96,78,48,222
Sene,10th,2010,Oromia,Arsi,Bale Gesgara,13,94,28,135
Tahesas,4th,2011,Oromia,Guji,Negele Town,8,23,95,126
Ginbot,9th,2010,Oromia,West Arsi,Bishan Guracha Town,1,58,90,149
Megabit,7th,2009,Oromia,Bale,Dinsho,98,80,40,218
Tahesas,4th,2011,Oromia,Borena,Dubluk,71,83,31,185
Teqemt,2nd,2010,Oromia,Bale,Seweyna,11,59,60,130
Nehase,12th,2010,Oromia,South West Shewa,Woliso Rural,44,67,87,198
Ginbot,9th,2011,Oromia,Qeleme Wellega,Gawo Qebe,35,95,56,186
Hamle,11th,2009,Oromia,Arsi,Ludehetosa,44,94,45,183
Hedar,3rd,2010,Oromia,West Wellega,Genji,47,93,38,178
Tir,5th,2010,Oromia,Ilu Aba Bora,Halu,72,13,72,157
Megabit,7th,2009,Oromia,West Arsi,Dodola Rural,28,61,4,93
Hedar,3rd,2010,Oromia,Arsi,Bekoji Town,54,82,15,151
Nehase,12th,2009,Oromia,Horo Gudru Wellega,Jima Geneti,29,44,84,157
Ginbot,9th,2011,Oromia,South West Shewa,Woliso Rural,88,18,16,122
Nehase,12th,2010,Oromia,South West Shewa,Becho,82,93,39,214
Meskerem,1st,2011,Oromia,East Shewa,Liben,29,91,49,169
Nehase,12th,2009,Oromia,Ilu Aba Bora,Metu Town,54,21,58,133
Sene,10th,2010,Oromia,South West Shewa,Dawo,16,42,91,149
Miyazia,8th,2011,Oromia,Horo Gudru Wellega,Horo,54,74,42,170
Meskerem,1st,2010,Oromia,Arsi,Sude,83,90,97,270
Meskerem,1st,2010,Oromia,Guji,Dima,96,35,3,134
Sene,10th,2011,Oromia,East Shewa,Lomme,53,69,86,208
Sene,10th,2010,Oromia,North Shewa,Aleiltu,40,13,44,97
Ginbot,9th,2011,Oromia,East Shewa,Lomme,0,12,97,109
Megabit,7th,2011,Oromia,Guji,Dima,44,66,7,117
Sene,10th,2009,Oromia,East Hararge,Aweday Town,12,21,31,64
Miyazia,8th,2011,Oromia,West Guji,Gelana,45,18,87,150
Nehase,12th,2010,Oromia,West Hararge,West Harerge	Gumbi Bordede,56,67,53,176
Ginbot,9th,2011,Oromia,East Shewa,Gimbichu,69,30,92,191
Megabit,7th,2009,Oromia,West Guji,Suro Barguda,82,29,69,180
Megabit,7th,2010,Oromia,West Hararge,Doba,48,68,72,188
Hedar,3rd,2011,Oromia,West Wellega,Babo Gembel,16,52,33,101
Ginbot,9th,2009,Oromia,Qeleme Wellega,Hawa Gelan,35,0,92,127
Hedar,3rd,2011,Oromia,South West Shewa,Bantu  Hospital,92,3,82,177
Teqemt,2nd,2011,Oromia,Arsi,Shenan Kolu,34,13,32,79
Megabit,7th,2009,Oromia,Guji,Adola Reda,13,63,17,93
Hamle,11th,2010,Oromia,Ilu Aba Bora,Didu,28,62,94,184
Megabit,7th,2010,Oromia,Horo Gudru Wellega,Abay Chomen,83,50,31,164
Hamle,11th,2010,Oromia,West Hararge,West Harerge	Gumbi Bordede,86,71,96,253
Teqemt,2nd,2011,Oromia,East Hararge,Kumbi,96,54,83,233
Sene,10th,2011,Oromia,East Shewa,Fentale,30,54,62,146
Nehase,12th,2009,Oromia,South West Shewa,Woliso Town,46,60,65,171
Hamle,11th,2010,Oromia,West Wellega,Nole Kaba,15,61,87,163
Yekatit,6th,2010,Oromia,Horo Gudru Wellega,Amuru,6,37,27,70
Megabit,7th,2011,Oromia,East Wellega,Limu,45,62,5,112
Teqemt,2nd,2010,Oromia,West Wellega,Yubdo,38,76,24,138
Sene,10th,2010,Oromia,Ilu Aba Bora,Metu Rural,83,67,13,163
Sene,10th,2010,Oromia,Finfine Zuria,Sebeta Awas,86,88,71,245
Megabit,7th,2009,Oromia,West Shewa,Dendi,65,9,14,88
Nehase,12th,2010,Oromia,Guji,Bore,68,25,38,131
Nehase,12th,2009,Oromia,East Wellega,Jimma Arjo,55,55,98,208
Teqemt,2nd,2011,Oromia,Borena,Moyale Hospital,75,23,30,128
Hedar,3rd,2011,Oromia,Jimma,O/Beyam,64,84,63,211
Ginbot,9th,2010,Oromia,East Hararge,Meyu Muleke,91,22,13,126
Miyazia,8th,2009,Oromia,West Guji,Hanbala,51,69,7,127
Miyazia,8th,2010,Oromia,South West Shewa,Becho,7,97,76,180
Megabit,7th,2009,Oromia,West Wellega,Nejo Town,51,83,47,181
Megabit,7th,2009,Oromia,West Shewa,Inchini Hospital,75,95,24,194
Tahesas,4th,2011,Oromia,East Wellega,Kiremu,53,53,63,169
Tir,5th,2011,Oromia,Buno Bedele,Dedesa,75,52,75,202
Megabit,7th,2010,Oromia,West Wellega,Mendi Town,40,59,35,134
Miyazia,8th,2010,Oromia,North Shewa,Kuyu Hospital,14,86,60,160
Megabit,7th,2010,Oromia,East Hararge,Chinakesen,40,56,67,163
Teqemt,2nd,2011,Oromia,Buno Bedele,Bedele Zuriya,96,99,25,220
Miyazia,8th,2011,Oromia,Buno Bedele,Bedele Hospital,53,16,11,80
Hedar,3rd,2011,Oromia,Buno Bedele,Bedele Town,77,83,69,229
Hamle,11th,2010,Oromia,South West Shewa,Tole,90,50,37,177
Nehase,12th,2010,Oromia,East Hararge,Meta,93,39,48,180
Ginbot,9th,2009,Oromia,West Wellega,Guliso,33,24,89,146
Hamle,11th,2009,Oromia,West Shewa,Dano,15,64,94,173
Megabit,7th,2011,Oromia,West Hararge,Mesela,63,4,26,93
Miyazia,8th,2009,Oromia,Horo Gudru Wellega,Abay Chomen,79,52,90,221
Hedar,3rd,2011,Oromia,West Arsi,Dodola Town,87,5,75,167
Miyazia,8th,2010,Oromia,West Arsi,Siraro,23,58,32,113
Hedar,3rd,2011,Oromia,Nekemte Town,Nekemte Town,90,56,33,179
Hedar,3rd,2010,Oromia,Guji,Dima,91,54,91,236
Yekatit,6th,2009,Oromia,South West Shewa,Kersana Malima,57,13,54,124
Meskerem,1st,2011,Oromia,South West Shewa,Wonchi,13,87,49,149
Ginbot,9th,2011,Oromia,West Hararge,Mesela,81,26,94,201
Ginbot,9th,2009,Oromia,Qeleme Wellega,Dambi Dollo,58,22,90,170
Nehase,12th,2009,Oromia,South West Shewa,Ilu,64,69,74,207
Hamle,11th,2010,Oromia,Jimma,Tiro Afeta,43,61,80,184
Yekatit,6th,2010,Oromia,Guji,Adola Hospital,11,76,82,169
Ginbot,9th,2010,Oromia,Qeleme Wellega,Anfilo,23,43,38,104
Megabit,7th,2009,Oromia,West Shewa,Ilu Galan,18,11,24,53
Tir,5th,2009,Oromia,North Shewa,Girar Jarso,58,76,42,176
Megabit,7th,2009,Oromia,West Wellega,Ayira Hospital,53,11,6,70
Tir,5th,2009,Oromia,East Shewa,Liben,79,9,15,103
Hamle,11th,2010,Oromia,Jimma,Mancho,56,69,12,137
Ginbot,9th,2010,Oromia,West Hararge,Boke,0,20,98,118
Hamle,11th,2009,Oromia,East Hararge,Kurfa Chele,21,18,32,71
Tir,5th,2011,Oromia,Qeleme Wellega,Jimma Horo,88,11,94,193
Hamle,11th,2010,Oromia,Ilu Aba Bora,Halu,60,10,4,74
Hamle,11th,2010,Oromia,Jimma,Limu Kosa,92,48,58,198
Tir,5th,2010,Oromia,Guji,Bore,16,11,49,76
Megabit,7th,2009,Oromia,West Arsi,Arsi Negele Town,85,62,19,166
Meskerem,1st,2011,Oromia,East Wellega,Gobu Seyo,66,63,12,141
Ginbot,9th,2010,Oromia,Buno Bedele,Bedele Hospital,30,9,96,135
Sene,10th,2011,Oromia,West Shewa,Gojo Hospital,0,16,57,73
Teqemt,2nd,2010,Oromia,North Shewa,Dera Hospital,68,30,14,112
Nehase,12th,2009,Oromia,Qeleme Wellega,Hawa Gelan,30,86,59,175
Hedar,3rd,2010,Oromia,East Hararge,Chinakesen,69,79,42,190
Yekatit,6th,2010,Oromia,Arsi,Deksis,15,62,75,152
Meskerem,1st,2010,Oromia,Jimma,Omonada,11,26,36,73
Miyazia,8th,2011,Oromia,West Wellega,Mene Sibu,22,25,34,81
Miyazia,8th,2009,Oromia,Ilu Aba Bora,Doreni,75,59,95,229
Hedar,3rd,2011,Oromia,Ilu Aba Bora,Bure,57,84,1,142
Yekatit,6th,2009,Oromia,East Wellega,Leqa Dulecha,42,78,75,195
Hamle,11th,2010,Oromia,Finfine Zuria,Sebeta Awas,58,53,59,170
Ginbot,9th,2009,Oromia,East Hararge,Midega Tole,69,80,43,192
Sene,10th,2011,Oromia,East Hararge,Meta,96,23,17,136
Teqemt,2nd,2011,Oromia,Borena,El Way,28,23,32,83
Tir,5th,2011,Oromia,West Arsi,Shala,70,42,32,144
Yekatit,6th,2010,Oromia,Bale,Dawe Serar,35,69,97,201
Sene,10th,2009,Oromia,West Hararge,Habro,54,88,15,157
Tir,5th,2010,Oromia,Finfine Zuria,Berreh,87,68,64,219
Tir,5th,2011,Oromia,East Hararge,Gursum,40,28,72,140
Megabit,7th,2011,Oromia,West Shewa,Bako Tibe,99,87,77,263
Tahesas,4th,2010,Oromia,Arsi,Digeluna Tijo,5,75,8,88
Megabit,7th,2009,Oromia,West Arsi,Arsi Negele Rural,2,72,20,94
Ginbot,9th,2009,Oromia,Jimma,Sigmo,95,69,79,243
Megabit,7th,2011,Oromia,West Wellega,Seyo Nole,30,46,25,101
Sene,10th,2011,Oromia,West Arsi,Dodola Rural,50,88,95,233
Yekatit,6th,2011,Oromia,Arsi,Dodota,44,30,76,150
Yekatit,6th,2010,Oromia,Horo Gudru Wellega,Jima Geneti,90,53,67,210
Hamle,11th,2010,Oromia,West Wellega,Gimbi Public  Hospital,7,98,82,187
Miyazia,8th,2009,Oromia,West Shewa,Abuna Gindeberet,91,99,81,271
Yekatit,6th,2009,Oromia,West Shewa,Tikur Enchini,75,1,73,149
Hedar,3rd,2010,Oromia,East Wellega,Jimma Arjo,63,84,72,219
Yekatit,6th,2010,Oromia,Finfine Zuria,Mullo,76,23,39,138
Megabit,7th,2011,Oromia,West Hararge,Hawi Gudina,92,64,8,164
Tahesas,4th,2010,Oromia,South West Shewa,Becho,5,89,7,101
Sene,10th,2011,Oromia,East Hararge,Gursum,44,72,20,136
Hedar,3rd,2011,Oromia,Qeleme Wellega,Anfilo,20,4,27,51
Yekatit,6th,2009,Oromia,Ilu Aba Bora,Ale,91,44,38,173
Sene,10th,2010,Oromia,East Hararge,Kurfa Chele,94,46,96,236
Tahesas,4th,2011,Oromia,East Hararge,Gursum,46,72,94,212
Meskerem,1st,2011,Oromia,West Arsi,Gambo Hospital,20,19,36,75
Hamle,11th,2010,Oromia,Ambo Town,Ambo Town,57,98,49,204
Miyazia,8th,2011,Oromia,East Hararge,Babile Woreda,98,97,30,225
Tir,5th,2010,Oromia,Assela Town,Assela Town,22,59,49,130
Sene,10th,2010,Oromia,Bale,Ginir Town,79,54,6,139
Hamle,11th,2010,Oromia,Guji,Aga Wayyu,30,25,47,102
Tahesas,4th,2011,Oromia,Horo Gudru Wellega,Chomen Guduru,7,83,66,156
Sene,10th,2011,Oromia,East Hararge,Jarso,40,78,94,212
Megabit,7th,2011,Oromia,Guji,Negele Town,68,9,61,138
Sene,10th,2009,Oromia,West Hararge,Tulo,30,82,17,129
Miyazia,8th,2009,Oromia,East Hararge,Meyu Muleke,42,4,45,91
Nehase,12th,2009,Oromia,Ilu Aba Bora,Didu,1,16,71,88
Sene,10th,2009,Oromia,Arsi,Shirka,70,7,64,141
Megabit,7th,2010,Oromia,West Hararge,Anchar,87,8,0,95
Hamle,11th,2009,Oromia,West Hararge,Chiro Hospital,68,7,90,165
Yekatit,6th,2010,Oromia,Jimma,Seka Chekorsa,66,22,35,123
Sene,10th,2009,Oromia,East Wellega,Boneya Bushe,83,11,12,106
Sene,10th,2009,Oromia,Bale,Ginir Town,75,96,5,176
Meskerem,1st,2011,Oromia,Guji,Wadara,37,9,8,54
Ginbot,9th,2011,Oromia,Borena,Yabelo,3,52,58,113
Sene,10th,2010,Oromia,West Wellega,Boji Cheqorsa,19,4,36,59
Megabit,7th,2010,Oromia,West Guji,Bule Hora,68,78,74,220
Teqemt,2nd,2011,Oromia,Nekemte Town,Nekemte Town,42,28,38,108
Tir,5th,2011,Oromia,West Hararge,Bedesa Town,53,80,58,191
Hedar,3rd,2010,Oromia,Finfine Zuria,Sebeta Awas,2,31,84,117
Meskerem,1st,2011,Oromia,East Hararge,Midega Tole,46,12,23,81
Tir,5th,2009,Oromia,Arsi,Chole,39,47,65,151
Tir,5th,2009,Oromia,West Arsi,Dodola Town,7,29,3,39
Meskerem,1st,2010,Oromia,West Wellega,Haru,21,41,45,107
Meskerem,1st,2011,Oromia,Bale,Berbere,66,29,67,162
Miyazia,8th,2011,Oromia,East Hararge,Haromaya Rural,75,4,58,137
Tahesas,4th,2011,Oromia,Jimma,Limu Hospital,76,44,20,140
Megabit,7th,2010,Oromia,East Hararge,Bedeno,22,69,6,97
Sene,10th,2010,Oromia,Horo Gudru Wellega,Jarte Jardga,13,26,7,46
Meskerem,1st,2010,Oromia,South West Shewa,Goro,9,71,34,114
Teqemt,2nd,2010,Oromia,East Hararge,Midega Tole,33,32,58,123
Hedar,3rd,2010,Oromia,South West Shewa,Goro,68,71,66,205
Yekatit,6th,2011,Oromia,South West Shewa,Dawo,68,80,84,232
Nehase,12th,2009,Oromia,West Hararge,Mesela,35,36,40,111
Sene,10th,2010,Oromia,South West Shewa,Woliso Rural,48,76,91,215
Megabit,7th,2011,Oromia,Jimma,Dedo,92,2,93,187
Megabit,7th,2010,Oromia,East Wellega,Guto Gida,64,80,91,235
Sene,10th,2010,Oromia,East Hararge,Deder,94,69,59,222
Hamle,11th,2009,Oromia,North Shewa,Jido,17,46,74,137
Tahesas,4th,2011,Oromia,West Shewa,Bako Hospital,83,68,34,185
Tir,5th,2010,Oromia,West Hararge,West Harerge	Gumbi Bordede,88,22,97,207
Megabit,7th,2010,Oromia,West Shewa,Jibat,7,39,81,127
Tahesas,4th,2011,Oromia,Ilu Aba Bora,Algesachi,51,2,17,70
Megabit,7th,2010,Oromia,Qeleme Wellega,Jimma Horo,87,67,50,204
Nehase,12th,2010,Oromia,West Shewa,Bako Hospital,21,22,38,81
Tir,5th,2009,Oromia,East Hararge,Chelenko Hospital,59,32,7,98
Tir,5th,2009,Oromia,West Hararge,Bedesa Town,43,30,24,97
Tir,5th,2010,Oromia,Jimma,Shabe,66,92,43,201
Yekatit,6th,2009,Oromia,Guji,Negele Town,88,35,23,146
Ginbot,9th,2009,Oromia,Borena,Yabelo,57,94,40,191
Yekatit,6th,2011,Oromia,Qeleme Wellega,Hawa Gelan Hosp,93,71,77,241
Tir,5th,2011,Oromia,South West Shewa,Wonchi,69,4,8,81
Yekatit,6th,2010,Oromia,West Hararge,Mesela,18,31,83,132
Meskerem,1st,2011,Oromia,West Hararge,Bedesa Town,85,19,50,154
Teqemt,2nd,2011,Oromia,Jimma,Omo Nada Hospital,27,23,93,143
Miyazia,8th,2009,Oromia,East Shewa,Adama,49,33,95,177
Nehase,12th,2009,Oromia,East Hararge,Girawa,86,27,17,130
Miyazia,8th,2009,Oromia,Ilu Aba Bora,Nono Sele,71,91,91,253
Meskerem,1st,2011,Oromia,Ilu Aba Bora,Hurumu,84,23,79,186
Tir,5th,2010,Oromia,Bale,Delo Mena,43,11,45,99
Ginbot,9th,2010,Oromia,Jimma,Gomma,87,61,79,227
Tahesas,4th,2010,Oromia,West Wellega,Ayira Hospital,20,23,77,120
Sene,10th,2009,Oromia,East Wellega,Gobu Seyo,52,44,34,130
Ginbot,9th,2009,Oromia,Horo Gudru Wellega,Gudru,10,0,26,36
Tahesas,4th,2010,Oromia,Guji,Girja,84,43,16,143
Teqemt,2nd,2010,Oromia,East Wellega,Leqa Dulecha,4,69,76,149
Tir,5th,2009,Oromia,Finfine Zuria,Berreh,9,79,8,96
Megabit,7th,2011,Oromia,Qeleme Wellega,Hawa Gelan Hosp,41,31,35,107
Sene,10th,2010,Oromia,West Guji,Kercha,63,31,55,149
Ginbot,9th,2010,Oromia,West Shewa,Chelia,78,66,72,216
Megabit,7th,2009,Oromia,West Arsi,Dodola Rural,6,27,67,100
Hedar,3rd,2010,Oromia,Woliso Town,Woliso Town,33,45,66,144
Hedar,3rd,2011,Oromia,Ilu Aba Bora,Ale,29,54,22,105
Tir,5th,2011,Oromia,East Hararge,Kersa Eh,71,19,87,177
Ginbot,9th,2009,Oromia,Qeleme Wellega,Dambi Dolo Hospital,26,18,48,92
Meskerem,1st,2010,Oromia,East Shewa,Olanciti Hospital,54,62,81,197
Hedar,3rd,2010,Oromia,Sebeta Town,Sebeta Town,87,22,15,124
Yekatit,6th,2010,Oromia,South West Shewa,Goro,4,49,93,146
Sene,10th,2009,Oromia,Finfine Zuria,Mullo,26,36,38,100
Miyazia,8th,2011,Oromia,West Shewa,Bako Hospital,66,54,49,169
Hamle,11th,2009,Oromia,East Wellega,Boneya Bushe,88,21,56,165
Hamle,11th,2010,Oromia,Ilu Aba Bora,Yayu,79,15,32,126
Tir,5th,2010,Oromia,Arsi,Digeluna Tijo,54,57,0,111
Megabit,7th,2011,Oromia,Horo Gudru Wellega,Gudru,61,96,45,202
Megabit,7th,2009,Oromia,Jimma,Setema,90,47,70,207
Nehase,12th,2010,Oromia,West Shewa,Liban Jawi,31,12,70,113
Tahesas,4th,2011,Oromia,Arsi,Bale Gesgara,92,54,66,212
Nehase,12th,2010,Oromia,West Hararge,Boke,66,25,18,109
Megabit,7th,2009,Oromia,Jimma,B/Tolyi,49,0,56,105
Tahesas,4th,2011,Oromia,West Wellega,Genji,8,74,12,94
Megabit,7th,2010,Oromia,West Arsi,Bishan Guracha Town,6,83,54,143
Yekatit,6th,2009,Oromia,West Arsi,Siraro,15,46,41,102
Meskerem,1st,2010,Oromia,Finfine Zuria,Akaki,76,12,79,167
Ginbot,9th,2010,Oromia,West Wellega,Nejo Rural,86,79,80,245
Sene,10th,2010,Oromia,East Shewa,Gimbichu,93,28,50,171
Megabit,7th,2010,Oromia,East Wellega,Kiremu,23,52,21,96
Meskerem,1st,2010,Oromia,East Shewa,Adea,67,16,17,100
Hamle,11th,2009,Oromia,Arsi,Zeway Dugda,33,34,34,101
Hamle,11th,2009,Oromia,Finfine Zuria,Holeta,42,25,62,129
Tir,5th,2009,Oromia,East Hararge,Haromaya Rural,8,10,6,24
Hedar,3rd,2011,Oromia,Lege Dadi Lege Tafo Town,Lege Dadi Lege Tafo Town,76,87,29,192
Hamle,11th,2010,Oromia,Finfine Zuria,Sululta Town,75,1,18,94
Meskerem,1st,2011,Oromia,West Arsi,Arsi Negele Town,24,17,83,124
Yekatit,6th,2010,Oromia,West Hararge,West Harerge	Gumbi Bordede,0,38,28,66
Tahesas,4th,2011,Oromia,Jimma,Nono Benja,73,9,80,162
Teqemt,2nd,2010,Oromia,East Wellega,Guto Gida,61,91,52,204
Yekatit,6th,2010,Oromia,East Wellega,Gobu Seyo,80,49,73,202
Hamle,11th,2009,Oromia,Jimma,Limu Hospital,40,17,71,128
Miyazia,8th,2010,Oromia,East Shewa,Lomme,59,6,91,156
Sene,10th,2009,Oromia,Bale,Dinsho,95,18,81,194
Meskerem,1st,2011,Oromia,Woliso Town,Woliso Town,32,70,80,182
Nehase,12th,2009,Oromia,West Shewa,Guder Hosp,46,53,58,157
Hedar,3rd,2011,Oromia,West Guji,Bule Hora Toun,33,84,27,144
Nehase,12th,2009,Oromia,East Hararge,Chelenko Hospital,40,12,85,137
Megabit,7th,2011,Oromia,East Hararge,Deder,56,96,39,191
Yekatit,6th,2010,Oromia,East Hararge,Haromaya Town,11,5,39,55
Meskerem,1st,2011,Oromia,West Wellega,Nole Kaba,60,32,50,142
Tahesas,4th,2011,Oromia,Arsi,Tiyo,50,0,40,90
Meskerem,1st,2010,Oromia,West Arsi,Dodola Town,33,38,1,72
Hedar,3rd,2011,Oromia,Holeta Town,Holeta Town,70,2,74,146
Teqemt,2nd,2011,Oromia,Jimma,Dedo,13,17,64,94
Miyazia,8th,2011,Oromia,West Hararge,Chiro Hospital,3,41,26,70
Hamle,11th,2009,Oromia,North Shewa,Hidabu Abote,87,73,80,240
Yekatit,6th,2010,Oromia,West Shewa,Midakegni,63,16,34,113
Nehase,12th,2009,Oromia,East Shewa,Dugda,48,87,16,151
Tir,5th,2010,Oromia,East Wellega,Guto Gida,51,34,85,170
Hedar,3rd,2011,Oromia,Arsi,Shirka,25,8,49,82
Nehase,12th,2009,Oromia,West Shewa,Dano,24,78,79,181
Teqemt,2nd,2010,Oromia,North Shewa,Debre Libanos,26,56,41,123
Hedar,3rd,2010,Oromia,West Wellega,Ayira,88,34,32,154
Tir,5th,2011,Oromia,West Wellega,Gimbi Public  Hospital,1,11,87,99
Nehase,12th,2009,Oromia,Qeleme Wellega,Dale Wabera,80,72,35,187
Miyazia,8th,2010,Oromia,South West Shewa,Tulu Bolo Hospital,11,95,34,140
Hedar,3rd,2010,Oromia,Ilu Aba Bora,Ale,82,75,53,210
Ginbot,9th,2010,Oromia,East Shewa,Batu,66,98,13,177
Yekatit,6th,2010,Oromia,West Shewa,Gedo Hospital,77,93,90,260
Hamle,11th,2009,Oromia,West Guji,Abaya,2,94,11,107
Meskerem,1st,2010,Oromia,West Shewa,Nono,61,92,67,220
Sene,10th,2009,Oromia,Arsi,Munesa,32,82,18,132
Teqemt,2nd,2011,Oromia,Bale,Delo Mena,44,64,27,135
Teqemt,2nd,2011,Oromia,West Hararge,Tulo,61,20,48,129
Yekatit,6th,2010,Oromia,North Shewa,Yaya Gulele,95,65,46,206
Miyazia,8th,2010,Oromia,Jimma,Limu Seka,19,23,85,127
Teqemt,2nd,2011,Oromia,Finfine Zuria,Sebeta Awas,92,70,85,247
Sene,10th,2011,Oromia,West Wellega,Lata Sibu,22,44,88,154
Hedar,3rd,2011,Oromia,West Hararge,Chiro Hospital,71,14,55,140
Tahesas,4th,2010,Oromia,East Shewa,Bora,53,98,42,193
Ginbot,9th,2011,Oromia,Holeta Town,Holeta Town,71,0,67,138
Megabit,7th,2009,Oromia,West Guji,Dugda Dawa,23,58,25,106
Nehase,12th,2010,Oromia,West Wellega,Genji,26,23,70,119
Hamle,11th,2010,Oromia,Borena,Moyale,34,36,22,92
Ginbot,9th,2010,Oromia,Guji,Adola Reda,19,47,33,99
Ginbot,9th,2009,Oromia,Borena,Moyale,70,88,10,168
Tahesas,4th,2011,Oromia,Buno Bedele,Meko,78,65,41,184
Yekatit,6th,2010,Oromia,East Wellega,Jimma Arjo,25,8,1,34
Megabit,7th,2010,Oromia,Buno Bedele,Dedesa,44,47,73,164
Ginbot,9th,2009,Oromia,Arsi,Guna,89,68,14,171
Yekatit,6th,2010,Oromia,Jimma,Mancho,60,4,68,132
Hedar,3rd,2011,Oromia,East Hararge,Kombolicha,27,82,53,162
Megabit,7th,2009,Oromia,Bale,Gasera,1,77,25,103
Ginbot,9th,2010,Oromia,West Guji,Mkelka Soda,11,63,22,96
Ginbot,9th,2010,Oromia,Ilu Aba Bora,Halu,96,0,87,183
Tahesas,4th,2011,Oromia,West Arsi,Gambo Hospital,29,8,84,121
Sene,10th,2009,Oromia,Qeleme Wellega,Anfilo,35,98,84,217
Megabit,7th,2011,Oromia,South West Shewa,Ameya Hospital,50,63,99,212
Nehase,12th,2009,Oromia,Qeleme Wellega,Gawo Qebe,43,90,27,160
Miyazia,8th,2011,Oromia,Bale,Goba Town,74,93,18,185
Sene,10th,2009,Oromia,Ilu Aba Bora,Metu Rural,54,3,16,73
Hamle,11th,2010,Oromia,Guji,Shakiso Town,77,12,28,117
Yekatit,6th,2010,Oromia,West Shewa,Bako Tibe,40,25,88,153
Megabit,7th,2009,Oromia,Borena,Guchi,95,47,28,170
Miyazia,8th,2009,Oromia,East Hararge,Fedis,14,34,11,59
Tir,5th,2011,Oromia,Borena,El Way,11,34,23,68
Sene,10th,2011,Oromia,West Shewa,Ambo Hospital,54,5,99,158
Meskerem,1st,2010,Oromia,Guji,Goro Dola,62,26,91,179
Teqemt,2nd,2011,Oromia,West Shewa,Gindeberet Hospital,17,35,26,78
Megabit,7th,2009,Oromia,West Hararge,Meiso,63,95,68,226
Meskerem,1st,2010,Oromia,West Arsi,Wondo,18,97,11,126
Tir,5th,2010,Oromia,North Shewa,Dera,96,72,38,206
Tir,5th,2011,Oromia,East Hararge,Haromaya Town,42,61,3,106
Hamle,11th,2009,Oromia,East Shewa,Olanciti Hospital,57,16,60,133
Meskerem,1st,2011,Oromia,West Wellega,Nejo Hospital,26,56,91,173
Miyazia,8th,2009,Oromia,West Hararge,Gemechis,70,51,97,218
Teqemt,2nd,2011,Oromia,East Hararge,Chelenko Hospital,92,68,15,175
Miyazia,8th,2010,Oromia,Bale,Goro,0,65,24,89
Megabit,7th,2009,Oromia,Arsi,Amigna,2,57,49,108
Ginbot,9th,2009,Oromia,East Hararge,Deder,15,84,29,128
Ginbot,9th,2011,Oromia,East Wellega,Kiremu,18,16,74,108
Hedar,3rd,2011,Oromia,Arsi,Munesa,88,77,95,260
Teqemt,2nd,2011,Oromia,East Wellega,Gida Ayana,60,97,41,198
Sene,10th,2011,Oromia,Bale,Berbere,25,22,66,113
Tir,5th,2009,Oromia,Finfine Zuria,Mullo,5,62,62,129
Nehase,12th,2010,Oromia,West Shewa,Jeldu,1,13,60,74
Megabit,7th,2010,Oromia,West Wellega,Seyo Nole,73,93,41,207
Sene,10th,2010,Oromia,East Hararge,Chelenko Hospital,86,7,74,167
Megabit,7th,2011,Oromia,West Shewa,Codi,53,44,60,157
Miyazia,8th,2011,Oromia,West Arsi,Dodola Town,66,3,68,137
Tahesas,4th,2010,Oromia,Buno Bedele,Chewaqa,56,52,41,149
Tir,5th,2011,Oromia,North Shewa,Were Jarso,70,89,31,190
Sene,10th,2010,Oromia,Bishoftu Town,Bishoftu Town,3,92,18,113
Miyazia,8th,2009,Oromia,East Hararge,Jarso,47,13,54,114
Hedar,3rd,2010,Oromia,East Shewa,Gimbichu,4,7,65,76
Ginbot,9th,2010,Oromia,Arsi,Deksis,34,93,83,210
Ginbot,9th,2011,Oromia,Borena,Dubluk,75,21,95,191
Yekatit,6th,2010,Oromia,Jimma Spe Town,Jimma Spe Town,30,98,91,219
Megabit,7th,2011,Oromia,Arsi,Bale Gesgara,34,97,98,229
Meskerem,1st,2011,Oromia,East Wellega,Kiremu,15,56,7,78
Hedar,3rd,2011,Oromia,Nekemte Town,Nekemte Town,68,26,61,155
Tir,5th,2009,Oromia,West Shewa,Ambo Hospital,16,46,80,142
Sene,10th,2009,Oromia,West Wellega,Gimbi Rural,70,6,40,116
Megabit,7th,2011,Oromia,North Shewa,Dera Hospital,8,80,86,174
Teqemt,2nd,2010,Oromia,West Hararge,Mesela,24,46,2,72
Yekatit,6th,2010,Oromia,Ilu Aba Bora,Bilonopa,92,17,15,124
Miyazia,8th,2011,Oromia,West Arsi,Kokosa  Hospital,25,25,12,62
Teqemt,2nd,2010,Oromia,East Shewa,Lomme,22,44,29,95
Hedar,3rd,2010,Oromia,Bale,Agarfa,93,11,25,129
Meskerem,1st,2010,Oromia,West Wellega,Seyo Nole,99,29,58,186
Tir,5th,2011,Oromia,Buno Bedele,Bedele Hospital,35,38,56,129
Sene,10th,2011,Oromia,North Shewa,Kuyu,54,91,90,235
Megabit,7th,2009,Oromia,West Arsi,Wondo,2,32,6,40
Tahesas,4th,2010,Oromia,West Arsi,Kore,27,43,51,121
Teqemt,2nd,2011,Oromia,East Wellega,Guto Gida,45,90,3,138
Ginbot,9th,2011,Oromia,Finfine Zuria,Sebeta Awas,92,41,17,150
Megabit,7th,2010,Oromia,Jimma,Dedo,96,54,4,154
Megabit,7th,2009,Oromia,Bale,Gololcha,28,23,75,126
Meskerem,1st,2011,Oromia,East Wellega,Boneya Bushe,19,68,2,89
Yekatit,6th,2010,Oromia,East Hararge,Kumbi,99,94,82,275
Nehase,12th,2009,Oromia,South West Shewa,Wonchi,83,12,8,103
Yekatit,6th,2010,Oromia,Horo Gudru Wellega,Horro Buluk,54,86,70,210
Nehase,12th,2009,Oromia,West Wellega,Lata Sibu,30,5,15,50
Miyazia,8th,2011,Oromia,South West Shewa,Ilu,44,75,17,136
Miyazia,8th,2009,Oromia,Borena,Yabelo Hospital,63,63,0,126
Megabit,7th,2010,Oromia,North Shewa,Debre Libanos,29,19,76,124
Tir,5th,2009,Oromia,East Hararge,Kombolicha,7,48,78,133
Yekatit,6th,2010,Oromia,Adama Special Town,Adama Town,92,77,51,220
Hedar,3rd,2011,Oromia,Borena,Moyale,19,20,46,85
Yekatit,6th,2010,Oromia,Arsi,Guna,32,52,14,98
Miyazia,8th,2009,Oromia,North Shewa,Fichetown,6,40,60,106
Teqemt,2nd,2011,Oromia,Horo Gudru Wellega,Abe Dengoro,45,85,86,216
Tir,5th,2009,Oromia,East Wellega,Nunu Qumba,34,74,26,134
Megabit,7th,2011,Oromia,East Hararge,Bisidimo Hospital,8,82,80,170
Teqemt,2nd,2011,Oromia,West Shewa,Ambo,65,72,84,221
Hamle,11th,2009,Oromia,East Hararge,Haromaya Town,74,73,1,148
Yekatit,6th,2009,Oromia,East Shewa,Adea,10,0,65,75
Megabit,7th,2011,Oromia,West Hararge,Anchar,64,61,27,152
Hamle,11th,2010,Oromia,East Wellega,Nunu Qumba,42,90,13,145
Tahesas,4th,2010,Oromia,East Hararge,Melka Belo,35,56,1,92
Hedar,3rd,2011,Oromia,Horo Gudru Wellega,Abay Chomen,17,43,20,80
Miyazia,8th,2011,Oromia,West Wellega,Boji Dermeji,76,65,73,214
Hedar,3rd,2010,Oromia,Qeleme Wellega,Gidami,90,84,17,191
Nehase,12th,2010,Oromia,Bale,Goba,12,26,51,89
Ginbot,9th,2009,Oromia,West Hararge,West Harerge	Gumbi Bordede,13,24,89,126
Yekatit,6th,2011,Oromia,South West Shewa,Goro,66,84,64,214
Ginbot,9th,2010,Oromia,West Arsi,Gedeb Asasa,17,43,41,101
Hedar,3rd,2010,Oromia,Bale,Dinsho,77,69,28,174
Hedar,3rd,2010,Oromia,Jimma,Kersa,84,64,74,222
Miyazia,8th,2009,Oromia,North Shewa,Abichugna,26,26,86,138
Hedar,3rd,2010,Oromia,West Shewa,Jeldu,70,17,27,114
Megabit,7th,2011,Oromia,Qeleme Wellega,Laloqile,57,37,94,188
Miyazia,8th,2011,Oromia,Bishoftu Town,Bishoftu Town,29,13,40,82
Tir,5th,2011,Oromia,West Arsi,Hebal Arsi,68,46,85,199
Yekatit,6th,2010,Oromia,Bale,Goba Town,83,80,29,192
Miyazia,8th,2011,Oromia,Arsi,Sude,89,88,50,227
Tir,5th,2010,Oromia,West Arsi,Dodola Rural,97,77,19,193
Ginbot,9th,2010,Oromia,East Shewa,Fentale,58,94,47,199
Nehase,12th,2009,Oromia,East Wellega,Gudeyabila,83,66,59,208
Yekatit,6th,2011,Oromia,North Shewa,Fichetown,30,95,38,163
Yekatit,6th,2010,Oromia,East Hararge,Kurfa Chele,20,33,6,59
Miyazia,8th,2010,Oromia,West Wellega,Ayira Hospital,45,35,27,107
Megabit,7th,2009,Oromia,Borena,Moyale,9,48,7,64
Sene,10th,2010,Oromia,West Wellega,Guliso,43,65,22,130
Nehase,12th,2009,Oromia,Buno Bedele,Diga,67,8,74,149
Yekatit,6th,2009,Oromia,West Arsi,Gedeb Asasa,15,45,44,104
Miyazia,8th,2009,Oromia,West Hararge,Anchar,25,56,51,132
Megabit,7th,2010,Oromia,Guji,Negele Hospital,14,2,46,62
Tir,5th,2011,Oromia,North Shewa,Debre Libanos,54,38,21,113
Megabit,7th,2009,Oromia,Jimma,Limu Kosa,71,99,30,200
Ginbot,9th,2009,Oromia,East Hararge,Girawa,3,51,11,65
Tahesas,4th,2010,Oromia,West Guji,Abaya,87,33,49,169
Sene,10th,2010,Oromia,West Wellega,Begi Hospital,8,74,12,94
Miyazia,8th,2010,Oromia,Bale,Gasera,50,28,92,170
Nehase,12th,2010,Oromia,Adama Special Town,Adama Town,61,54,42,157
Sene,10th,2009,Oromia,Horo Gudru Wellega,Gudru,13,14,24,51
Teqemt,2nd,2011,Oromia,West Hararge,Chiro Zuriya,70,51,56,177
Meskerem,1st,2011,Oromia,Horo Gudru Wellega,Jima Rare,68,59,33,160
Megabit,7th,2010,Oromia,East Hararge,Kurfa Chele,81,12,64,157
Nehase,12th,2010,Oromia,West Shewa,Abuna Gindeberet,6,95,18,119
Miyazia,8th,2011,Oromia,East Wellega,Jimma Arjo,9,28,73,110
Nehase,12th,2009,Oromia,Arsi,Aseko,82,72,48,202
Nehase,12th,2010,Oromia,North Shewa,Yaya Gulele,77,48,49,174
Hedar,3rd,2011,Oromia,Nekemte Town,Nekemte Town,63,40,18,121
Meskerem,1st,2010,Oromia,West Hararge,Daro Lebu,49,56,38,143
Yekatit,6th,2010,Oromia,East Wellega,Wayu Tuqa,66,54,88,208
Tahesas,4th,2010,Oromia,Buno Bedele,Meko,25,51,88,164
Sene,10th,2009,Oromia,Qeleme Wellega,Dambi Dollo,85,73,89,247
Tahesas,4th,2010,Oromia,Guji,Goro Dola,47,70,65,182
Hedar,3rd,2011,Oromia,Ilu Aba Bora,Nono Sele,93,82,16,191
Miyazia,8th,2010,Oromia,Ilu Aba Bora,Metu Rural,88,4,76,168
Megabit,7th,2010,Oromia,Bale,Goba,57,84,8,149
Meskerem,1st,2010,Oromia,Arsi,Tiyo,69,39,42,150
Teqemt,2nd,2011,Oromia,Ilu Aba Bora,Metu Rural,83,73,21,177
Yekatit,6th,2010,Oromia,West Shewa,Dano,70,41,3,114
Tahesas,4th,2011,Oromia,North Shewa,Debre Libanos,44,46,4,94
Sene,10th,2009,Oromia,Arsi,Sire,20,72,50,142
Meskerem,1st,2010,Oromia,Borena,Dilo,79,82,54,215
Sene,10th,2010,Oromia,Borena,Dilo,36,28,97,161
Sene,10th,2011,Oromia,Jimma,Gomma,18,81,41,140
Nehase,12th,2010,Oromia,North Shewa,Kuyu Hospital,50,32,36,118
Nehase,12th,2010,Oromia,East Hararge,Deder Hospital,58,40,86,184
Nehase,12th,2010,Oromia,West Guji,Gelana,86,76,84,246
Ginbot,9th,2010,Oromia,East Shewa,Adami Tulu Jido Kombolcha,60,32,95,187
Hedar,3rd,2011,Oromia,West Wellega,Kundala,39,44,25,108
Hamle,11th,2009,Oromia,Borena,Yabelo Rural,50,84,89,223
Hamle,11th,2010,Oromia,East Hararge,Haromaya Town,62,50,74,186
Yekatit,6th,2009,Oromia,West Hararge,Anchar,66,81,35,182
Hedar,3rd,2010,Oromia,Ilu Aba Bora,Nono Sele,21,80,51,152
Yekatit,6th,2010,Oromia,West Hararge,Anchar,60,36,66,162
Sene,10th,2010,Oromia,Arsi,Gololcha,8,78,92,178
Ginbot,9th,2011,Oromia,Bale,Arena Buluq,74,98,84,256
Meskerem,1st,2011,Oromia,West Arsi,Kokosa,46,43,67,156
Tir,5th,2009,Oromia,Horo Gudru Wellega,Amuru,40,46,10,96
Hamle,11th,2010,Oromia,East Wellega,Sibu Sire,96,16,63,175
Megabit,7th,2010,Oromia,West Wellega,Ayira Hospital,16,23,84,123
Tir,5th,2010,Oromia,Arsi,Dodota,55,60,45,160
Tahesas,4th,2010,Oromia,West Arsi,Wondo,71,77,62,210
Megabit,7th,2010,Oromia,Jimma,Guma,52,14,33,99
Hamle,11th,2010,Oromia,West Wellega,Nejo Hospital,30,27,10,67
Hamle,11th,2009,Oromia,East Hararge,Gole Oda,93,49,39,181
Tir,5th,2010,Oromia,Finfine Zuria,Berreh,22,16,78,116
Ginbot,9th,2010,Oromia,Arsi,Ludehetosa,92,15,9,116
Ginbot,9th,2009,Oromia,West Hararge,Tulo,30,48,30,108
Miyazia,8th,2009,Oromia,Finfine Zuria,Mullo,45,13,6,64
Hedar,3rd,2010,Oromia,West Hararge,Doba,95,84,83,262
Megabit,7th,2009,Oromia,Guji,Negele Town,84,56,30,170
Nehase,12th,2010,Oromia,Guji,Wadara,21,34,21,76
Ginbot,9th,2011,Oromia,Guji,Girja,17,10,60,87
Tir,5th,2009,Oromia,Arsi,Jeju,82,6,32,120
Hedar,3rd,2011,Oromia,West Wellega,Babo Gembel,94,18,19,131
Ginbot,9th,2010,Oromia,Borena,El Way,18,57,50,125
Hamle,11th,2010,Oromia,West Shewa,Jibat,54,89,51,194
Nehase,12th,2010,Oromia,South West Shewa,Ameya Hospital,20,15,89,124
Ginbot,9th,2011,Oromia,North Shewa,Fiche Hospital,96,92,53,241
Teqemt,2nd,2010,Oromia,West Hararge,Oda Bultum,24,4,24,52
Miyazia,8th,2011,Oromia,Jimma,Agaro Hospital,26,24,37,87
Teqemt,2nd,2010,Oromia,Ilu Aba Bora,Ale,10,46,45,101
Tir,5th,2011,Oromia,Guji,Negele Town,8,61,1,70
Hamle,11th,2009,Oromia,West Arsi,Gedeb Asasa,23,36,40,99
Hedar,3rd,2010,Oromia,Buno Bedele,Chewaqa,72,80,53,205
Yekatit,6th,2009,Oromia,East Shewa,Adama,34,37,80,151
Sene,10th,2011,Oromia,West Arsi,Kore,92,39,35,166
Tahesas,4th,2010,Oromia,East Hararge,Gole Oda,34,92,19,145
Hamle,11th,2009,Oromia,East Hararge,Gursum,92,90,99,281
Miyazia,8th,2010,Oromia,West Shewa,Bako Tibe,45,77,58,180
Teqemt,2nd,2010,Oromia,Assela Town,Assela Town,97,79,78,254
Teqemt,2nd,2011,Oromia,Bale,Agarfa,55,38,99,192
Megabit,7th,2010,Oromia,West Guji,Mkelka Soda,53,82,47,182
Yekatit,6th,2009,Oromia,Finfine Zuria,Sululta Town,77,86,82,245
Tahesas,4th,2010,Oromia,Guji,Dima,10,72,2,84
Ginbot,9th,2009,Oromia,West Arsi,Wondo,88,34,31,153
Tir,5th,2010,Oromia,Jimma,Guma,47,64,61,172
Nehase,12th,2009,Oromia,Ilu Aba Bora,Bilonopa,52,55,11,118
Miyazia,8th,2009,Oromia,Borena,Meyo,30,55,63,148
Megabit,7th,2009,Oromia,West Guji,Kercha,42,76,97,215
Sene,10th,2009,Oromia,Guji,Girja,73,20,37,130
Tahesas,4th,2011,Oromia,Jimma Spe Town,Jimma Spe Town,29,31,54,114
Hedar,3rd,2011,Oromia,Bale,Gasera,56,66,87,209
Megabit,7th,2010,Oromia,East Shewa,Adami Tulu Jido Kombolcha,16,93,73,182
Ginbot,9th,2011,Oromia,Buno Bedele,Boricha,98,33,93,224
Hedar,3rd,2010,Oromia,East Shewa,Adea,35,81,74,190
Miyazia,8th,2009,Oromia,Jimma,Setema,15,6,78,99
Sene,10th,2010,Oromia,Arsi,Robe,81,0,71,152
Hamle,11th,2010,Oromia,West Arsi,Dodola  Hospital,56,49,73,178
Tahesas,4th,2010,Oromia,Horo Gudru Wellega,Jima Rare,10,62,4,76
Megabit,7th,2009,Oromia,East Hararge,Bedeno,94,4,7,105
Megabit,7th,2009,Oromia,East Shewa,Bora,79,9,37,125
Ginbot,9th,2011,Oromia,West Shewa,Liban Jawi,37,68,28,133
Meskerem,1st,2010,Oromia,West Guji,Suro Barguda,40,33,89,162
Ginbot,9th,2010,Oromia,West Shewa,Midakegni,39,22,62,123
Hedar,3rd,2011,Oromia,East Hararge,Chelenko Hospital,70,15,71,156
Megabit,7th,2009,Oromia,Guji,Adola Town,57,12,76,145
Miyazia,8th,2011,Oromia,North Shewa,Fichetown,71,90,79,240
Sene,10th,2011,Oromia,Horo Gudru Wellega,Horo,45,56,97,198
Hamle,11th,2010,Oromia,Jimma,Limu Hospital,93,30,43,166
Sene,10th,2009,Oromia,West Hararge,Chiro Town,44,83,3,130
Yekatit,6th,2009,Oromia,Bale,Dawe Serar,88,92,81,261
Teqemt,2nd,2010,Oromia,West Wellega,Begi Hospital,35,16,27,78
Megabit,7th,2011,Oromia,East Wellega,Nunu Qumba,4,58,72,134
Hamle,11th,2009,Oromia,Arsi,Ludehetosa,79,79,21,179
Meskerem,1st,2010,Oromia,Borena,Arero,31,73,34,138
Hedar,3rd,2010,Oromia,Bale,Seweyna,31,75,20,126
Sene,10th,2010,Oromia,Borena,Dubluk,28,47,40,115
Hamle,11th,2009,Oromia,Jimma,Mana,44,90,4,138
Nehase,12th,2010,Oromia,East Wellega,Ebantu,23,38,41,102
Hedar,3rd,2011,Oromia,West Guji,Abaya,36,1,45,82
Sene,10th,2009,Oromia,Buno Bedele,Bedele Town,22,62,60,144
Yekatit,6th,2009,Oromia,Bale,Goba Town,90,82,97,269
Hedar,3rd,2010,Oromia,Arsi,Digeluna Tijo,76,12,63,151
Nehase,12th,2010,Oromia,Adama Special Town,Adama Town,26,32,78,136
Miyazia,8th,2011,Oromia,East Hararge,Meta,9,99,29,137
Meskerem,1st,2011,Oromia,Jimma,Limu Kosa,55,26,61,142
Hedar,3rd,2011,Oromia,East Wellega,Gobu Seyo,38,69,94,201
Hamle,11th,2009,Oromia,West Wellega,Homa,2,68,5,75
Yekatit,6th,2009,Oromia,Qeleme Wellega,Dale Sedi,55,91,4,150
Hamle,11th,2010,Oromia,Qeleme Wellega,Dale Wabera,35,89,59,183
Tir,5th,2009,Oromia,East Wellega,Sibu Sire,5,51,72,128
Hamle,11th,2010,Oromia,East Shewa,Boset,53,53,13,119
Hedar,3rd,2011,Oromia,Bale,Goba,34,95,46,175
Hamle,11th,2009,Oromia,Arsi,Deksis,54,53,12,119
Nehase,12th,2010,Oromia,South West Shewa,Becho,68,0,35,103
Meskerem,1st,2011,Oromia,East Wellega,Boneya Bushe,10,94,24,128
Nehase,12th,2009,Oromia,Bale,Gololcha,17,78,16,111
Meskerem,1st,2011,Oromia,West Guji,Abaya,13,17,24,54
Sene,10th,2010,Oromia,North Shewa,Yaya Gulele,3,33,32,68
Sene,10th,2009,Oromia,Arsi,Zeway Dugda,47,78,23,148
Ginbot,9th,2009,Oromia,West Shewa,Abuna Gindeberet,26,33,13,72
Hedar,3rd,2011,Oromia,West Guji,Bule Hora Hospital,77,71,4,152
Nehase,12th,2010,Oromia,East Hararge,Kurfa Chele,8,10,15,33
Sene,10th,2010,Oromia,Borena,Guchi,83,9,21,113
Nehase,12th,2010,Oromia,Bale,Sinana,45,9,69,123
Megabit,7th,2009,Oromia,East Wellega,Sibu Sire,50,71,44,165
Yekatit,6th,2010,Oromia,East Hararge,Midega Tole,81,34,24,139
Ginbot,9th,2010,Oromia,East Shewa,Bora,41,50,95,186
Miyazia,8th,2010,Oromia,East Wellega,Kiremu,56,26,78,160
Megabit,7th,2011,Oromia,Qeleme Wellega,Kake Hosp,9,51,12,72
Ginbot,9th,2009,Oromia,East Hararge,Babile Woreda,39,32,59,130
Tahesas,4th,2010,Oromia,West Arsi,Bishan Guracha Town,2,17,62,81
Ginbot,9th,2009,Oromia,Ilu Aba Bora,Metu Rural,93,17,66,176
Ginbot,9th,2009,Oromia,West Guji,Suro Barguda,72,26,15,113
Ginbot,9th,2011,Oromia,Bale,Dinsho,49,47,99,195
Sene,10th,2010,Oromia,East Hararge,Midega Tole,63,3,7,73
Hamle,11th,2010,Oromia,West Arsi,Siraro,65,71,82,218
Nehase,12th,2010,Oromia,Arsi,Dodota,58,73,79,210
Yekatit,6th,2011,Oromia,West Shewa,Dendi,51,15,40,106
Teqemt,2nd,2010,Oromia,West Shewa,Jeldu,14,65,92,171
Hamle,11th,2009,Oromia,East Shewa,Bora,14,85,75,174
Megabit,7th,2009,Oromia,Qeleme Wellega,Yemalogi Wolel,1,82,15,98
Teqemt,2nd,2010,Oromia,West Hararge,Burka Dimtu,52,91,28,171
Tahesas,4th,2010,Oromia,Assela Town,Assela Town,48,9,37,94
Teqemt,2nd,2011,Oromia,West Arsi,Loke Hada Hospital,65,66,67,198
Miyazia,8th,2011,Oromia,East Shewa,Fentale,86,25,7,118
Hedar,3rd,2010,Oromia,Jimma,Dedo,58,28,41,127
Sene,10th,2009,Oromia,West Hararge,Burka Dimtu,50,12,7,69
Megabit,7th,2011,Oromia,West Shewa,Inchini Hospital,23,94,74,191
Tahesas,4th,2010,Oromia,West Hararge,Anchar,10,12,76,98
Meskerem,1st,2011,Oromia,East Hararge,Kombolicha,18,54,76,148
Megabit,7th,2011,Oromia,South West Shewa,Becho,3,95,74,172
Miyazia,8th,2010,Oromia,West Wellega,Gimbi Adventist Hospital,42,56,45,143
Megabit,7th,2011,Oromia,West Shewa,Abuna Gindeberet,35,58,58,151
Tahesas,4th,2011,Oromia,East Wellega,Nunu Qumba,83,64,92,239
Hamle,11th,2010,Oromia,Arsi,Seru,43,82,10,135
Ginbot,9th,2011,Oromia,West Shewa,Inchini Hospital,31,78,8,117
Hamle,11th,2009,Oromia,Jimma,Tiro Afeta,64,11,94,169
Miyazia,8th,2011,Oromia,West Guji,Bule Hora Toun,85,81,66,232
Hedar,3rd,2010,Oromia,Borena,El Way,34,33,97,164
Ginbot,9th,2011,Oromia,West Shewa,Bako Tibe,28,99,11,138
Megabit,7th,2011,Oromia,Jimma,Chora Boter,3,46,81,130
Meskerem,1st,2011,Oromia,West Hararge,Gelemso Hospital,27,93,24,144
Yekatit,6th,2010,Oromia,East Hararge,Deder Town,40,83,23,146
Miyazia,8th,2010,Oromia,Borena,Guchi,85,4,59,148
Megabit,7th,2009,Oromia,Buno Bedele,Dedesa,66,66,17,149
Tahesas,4th,2010,Oromia,East Hararge,Deder Town,6,46,24,76
Yekatit,6th,2009,Oromia,North Shewa,Fichetown,93,21,7,121
Nehase,12th,2010,Oromia,Ilu Aba Bora,Metu Rural,25,38,15,78
Hedar,3rd,2011,Oromia,Borena,Moyale Hospital,16,4,36,56
Hamle,11th,2010,Oromia,Arsi,Guna,8,53,33,94
Sene,10th,2010,Oromia,Guji,Aga Wayyu,40,73,89,202
Megabit,7th,2010,Oromia,Buno Bedele,Chora,90,47,51,188
Ginbot,9th,2011,Oromia,Ilu Aba Bora,Bure,14,79,66,159
Miyazia,8th,2011,Oromia,North Shewa,Degem,14,54,92,160
Ginbot,9th,2010,Oromia,Jimma,Sekoru,91,87,51,229
Tir,5th,2010,Oromia,West Wellega,Gimbi Rural,71,44,18,133
Nehase,12th,2010,Oromia,West Hararge,Bedesa Town,96,25,50,171
Megabit,7th,2011,Oromia,West Arsi,Dodola Town,99,75,52,226
Tir,5th,2010,Oromia,West Shewa,Abuna Gindeberet,58,95,36,189
Ginbot,9th,2009,Oromia,West Arsi,Adaba,73,45,46,164
Miyazia,8th,2009,Oromia,West Guji,Bule Hora Toun,9,91,10,110
Meskerem,1st,2011,Oromia,Jimma,Seka Chekorsa,4,88,19,111
Miyazia,8th,2009,Oromia,West Hararge,West Harerge	Gumbi Bordede,29,89,92,210
Meskerem,1st,2010,Oromia,Ilu Aba Bora,Becho,88,87,70,245
Miyazia,8th,2011,Oromia,West Wellega,Gimbi Adventist Hospital,39,7,18,64
Hamle,11th,2009,Oromia,West Wellega,Mendi Town,10,27,35,72
Yekatit,6th,2009,Oromia,East Hararge,Midega Tole,83,46,85,214
Meskerem,1st,2011,Oromia,East Shewa,Lomme,27,50,14,91
Tahesas,4th,2010,Oromia,South West Shewa,Tole,82,82,44,208
Tir,5th,2009,Oromia,Horo Gudru Wellega,Horo,9,72,13,94
Hamle,11th,2009,Oromia,Jimma,Dedo,52,44,21,117
Tir,5th,2011,Oromia,Guji,Saba Boru,96,2,92,190
Hedar,3rd,2010,Oromia,West Shewa,Elifata,0,39,40,79
Megabit,7th,2011,Oromia,West Arsi,Kokosa,90,45,32,167
Megabit,7th,2010,Oromia,Finfine Zuria,Sululta Town,64,55,31,150
Tir,5th,2010,Oromia,West Arsi,Shala,79,35,83,197
Megabit,7th,2011,Oromia,West Wellega,Babo Gembel,53,18,32,103
Tir,5th,2010,Oromia,West Wellega,Babo Gembel,5,82,73,160
Tir,5th,2010,Oromia,West Arsi,Nensebo,29,10,35,74
Megabit,7th,2009,Oromia,East Hararge,Meyu Muleke,33,11,58,102
Ginbot,9th,2009,Oromia,Finfine Zuria,Sandefa,14,5,89,108
Nehase,12th,2010,Oromia,West Hararge,Daro Lebu,53,36,56,145
Teqemt,2nd,2010,Oromia,East Hararge,Goro Gutu,85,87,14,186
Ginbot,9th,2009,Oromia,Buno Bedele,Boricha,6,87,90,183
Ginbot,9th,2009,Oromia,West Shewa,Tikur Enchini,27,7,34,68
Ginbot,9th,2009,Oromia,West Guji,Kercha Hospital,17,35,50,102
Sene,10th,2010,Oromia,East Shewa,Adama,91,20,43,154
Tir,5th,2010,Oromia,Jimma,Sekoru,4,73,6,83
Megabit,7th,2010,Oromia,West Arsi,Kokosa,95,92,41,228
Meskerem,1st,2011,Oromia,Qeleme Wellega,Jimma Horo,92,20,43,155
Tahesas,4th,2011,Oromia,Arsi,Hitosa,45,29,81,155
Teqemt,2nd,2011,Oromia,East Wellega,Guto Gida,36,92,71,199
Hamle,11th,2009,Oromia,Horo Gudru Wellega,Shambu Town,84,8,97,189
Tir,5th,2009,Oromia,Guji,Anna Sora,29,28,65,122
Sene,10th,2010,Oromia,Arsi,Amigna,15,89,12,116
Tir,5th,2011,Oromia,West Guji,Gelana,14,93,7,114
Nehase,12th,2010,Oromia,South West Shewa,St.Luke Hospital,52,86,11,149
Meskerem,1st,2011,Oromia,West Wellega,Gimbi Adventist Hospital,30,72,45,147
Tir,5th,2011,Oromia,Jimma,Mana,26,49,33,108
Teqemt,2nd,2011,Oromia,West Wellega,Boji Cheqorsa,28,61,88,177
Yekatit,6th,2010,Oromia,Buno Bedele,Bedele Town,30,92,23,145
Miyazia,8th,2010,Oromia,North Shewa,Kuyu Hospital,11,42,23,76
Yekatit,6th,2009,Oromia,East Shewa,Mojo,45,65,65,175
Miyazia,8th,2011,Oromia,Finfine Zuria,Sebeta Awas,19,27,87,133
Tir,5th,2010,Oromia,West Shewa,Gojo Hospital,26,48,12,86
Hedar,3rd,2010,Oromia,Nekemte Town,Nekemte Town,6,2,43,51
Sene,10th,2009,Oromia,West Arsi,Kore,17,75,94,186
Miyazia,8th,2011,Oromia,West Wellega,Gimbi Adventist Hospital,32,10,66,108
Sene,10th,2010,Oromia,Horo Gudru Wellega,Shambu Hospital,93,53,98,244
Yekatit,6th,2009,Oromia,North Shewa,Kuyu Hospital,48,11,62,121
Nehase,12th,2009,Oromia,West Hararge,Guba Qoricha,92,22,11,125
Teqemt,2nd,2010,Oromia,West Guji,Mkelka Soda,22,2,27,51
Hamle,11th,2010,Oromia,Arsi,Tena,49,52,22,123
Tir,5th,2009,Oromia,East Shewa,Liben,31,51,4,86
Megabit,7th,2009,Oromia,Buno Bedele,Boricha,66,76,48,190
Hamle,11th,2009,Oromia,West Arsi,Kore,47,29,6,82
Miyazia,8th,2009,Oromia,West Wellega,Mene Sibu,74,54,75,203
Megabit,7th,2011,Oromia,East Wellega,Sasiga,18,90,23,131
Meskerem,1st,2010,Oromia,Bale,Legehida,11,90,58,159
Hamle,11th,2010,Oromia,West Hararge,Chiro Zuriya,27,42,43,112
Hamle,11th,2010,Oromia,Jimma,Omo Nada Hospital,40,87,46,173
Tahesas,4th,2010,Oromia,Buno Bedele,Chora,48,7,15,70
Teqemt,2nd,2011,Oromia,Holeta Town,Holeta Town,25,68,34,127
Tir,5th,2009,Oromia,Buno Bedele,Dedesa,13,74,83,170
Teqemt,2nd,2011,Oromia,Buno Bedele,Meko,88,94,47,229
Ginbot,9th,2010,Oromia,East Wellega,Ebantu,45,17,75,137
Hedar,3rd,2010,Oromia,Guji,Hambela Wamena,19,8,86,113
Meskerem,1st,2011,Oromia,Borena,Dubluk,65,44,76,185
Hedar,3rd,2010,Oromia,East Wellega,Sasiga,3,15,43,61
Teqemt,2nd,2011,Oromia,Arsi,Enkelo Wabe,53,43,52,148
Teqemt,2nd,2010,Oromia,West Shewa,Bako Tibe,52,56,50,158
Nehase,12th,2010,Oromia,West Shewa,Ilu Galan,17,2,81,100
Miyazia,8th,2009,Oromia,Bale,Agarfa,27,39,16,82
Tir,5th,2011,Oromia,Buno Bedele,Bedele Town,55,39,43,137
Teqemt,2nd,2011,Oromia,East Hararge,Fedis,81,77,14,172
Miyazia,8th,2011,Oromia,West Hararge,Habro,95,75,80,250
Megabit,7th,2009,Oromia,West Wellega,Kundala,15,54,50,119
Sene,10th,2011,Oromia,West Shewa,Abuna Gindeberet,45,48,36,129
Hedar,3rd,2010,Oromia,West Wellega,Guliso,81,63,56,200
Miyazia,8th,2010,Oromia,Ilu Aba Bora,Hurumu,21,72,51,144
Tir,5th,2010,Oromia,Jimma,Tiro Afeta,72,40,7,119
Hamle,11th,2009,Oromia,Arsi,Amigna,27,46,66,139
Tir,5th,2010,Oromia,West Wellega,Jarso,3,90,90,183
Tahesas,4th,2010,Oromia,West Guji,Dugda Dawa,22,85,80,187
Miyazia,8th,2009,Oromia,Buno Bedele,Chewaqa,34,90,31,155
Hedar,3rd,2010,Oromia,Finfine Zuria,Sebeta Awas,13,79,22,114
Megabit,7th,2009,Oromia,East Hararge,Meta,77,50,96,223
Tir,5th,2009,Oromia,Ilu Aba Bora,Ale,88,80,7,175
Tir,5th,2010,Oromia,Bale,Seweyna,29,48,7,84
Teqemt,2nd,2011,Oromia,Arsi,Tena,40,12,64,116
Ginbot,9th,2011,Oromia,North Shewa,Hidabu Abote,6,40,67,113
Meskerem,1st,2011,Oromia,East Wellega,Gudeyabila,13,52,56,121
Tir,5th,2010,Oromia,Burayu Town,Burayu Town,80,34,77,191
Megabit,7th,2009,Oromia,Jimma,Guma,45,20,48,113
Megabit,7th,2010,Oromia,East Hararge,Meta,66,82,86,234
Megabit,7th,2011,Oromia,West Wellega,Nejo Rural,34,54,38,126
Ginbot,9th,2011,Oromia,West Guji,Bule Hora Hospital,50,68,93,211
Yekatit,6th,2010,Oromia,Qeleme Wellega,Dambi Dolo Hospital,27,94,64,185
Megabit,7th,2009,Oromia,East Hararge,Kurfa Chele,37,20,59,116
Megabit,7th,2011,Oromia,East Wellega,Kiremu,67,65,31,163
Ginbot,9th,2009,Oromia,West Arsi,Kore,16,20,90,126
Megabit,7th,2009,Oromia,Ilu Aba Bora,Didu,83,1,50,134
Sene,10th,2010,Oromia,Qeleme Wellega,Seyo,78,26,1,105
Yekatit,6th,2011,Oromia,West Arsi,Hebal Arsi,82,88,19,189
Yekatit,6th,2009,Oromia,Finfine Zuria,Sandefa,46,17,81,144
Ginbot,9th,2010,Oromia,East Shewa,Matahara,99,46,3,148
Nehase,12th,2009,Oromia,Buno Bedele,Bedele Town,93,72,86,251
Megabit,7th,2010,Oromia,Bale,Arena Buluq,20,52,81,153
Hamle,11th,2009,Oromia,West Arsi,Arsi Negele Town,40,88,80,208
Megabit,7th,2011,Oromia,East Wellega,Nunu Qumba,57,90,88,235
Nehase,12th,2010,Oromia,Guji,Negele Town,52,43,70,165
Yekatit,6th,2010,Oromia,West Shewa,Jeldu,91,87,87,265
Sene,10th,2009,Oromia,West Hararge,Bedesa Town,97,57,45,199
Miyazia,8th,2010,Oromia,Bale,Sinana,50,32,19,101
Tir,5th,2011,Oromia,Ilu Aba Bora,Becho,63,47,3,113
Ginbot,9th,2011,Oromia,Jimma,Seka Chekorsa,61,90,28,179
Yekatit,6th,2011,Oromia,Borena,Dire,67,67,27,161
Hedar,3rd,2010,Oromia,Arsi,Sude,87,36,40,163
Tir,5th,2009,Oromia,West Shewa,Dendi,39,61,53,153
Hedar,3rd,2011,Oromia,West Guji,Abaya,22,88,40,150
Tir,5th,2010,Oromia,South West Shewa,Ilu,99,8,71,178
Megabit,7th,2010,Oromia,Finfine Zuria,Sululta Town,79,75,80,234
Megabit,7th,2011,Oromia,South West Shewa,Bantu  Hospital,0,73,78,151
Ginbot,9th,2009,Oromia,East Shewa,Fentale,95,34,5,134
Yekatit,6th,2010,Oromia,West Shewa,Chelia,6,56,69,131
Ginbot,9th,2011,Oromia,Arsi,Munesa,14,61,33,108
Sene,10th,2009,Oromia,East Shewa,Gimbichu,3,58,79,140
Teqemt,2nd,2010,Oromia,North Shewa,Dera,58,10,47,115
Miyazia,8th,2009,Oromia,East Hararge,Babile,35,85,15,135
Meskerem,1st,2011,Oromia,Guji,Girja,86,68,81,235
Yekatit,6th,2011,Oromia,Jimma,Gomma,57,82,83,222
Hedar,3rd,2011,Oromia,East Shewa,Dugda,59,24,40,123
Yekatit,6th,2010,Oromia,South West Shewa,Becho,89,43,34,166
Megabit,7th,2011,Oromia,West Arsi,Shashemene Rural,0,36,42,78
Ginbot,9th,2009,Oromia,East Wellega,Kiremu,59,11,74,144
Teqemt,2nd,2010,Oromia,North Shewa,Debre Libanos,16,3,61,80
Tir,5th,2011,Oromia,West Arsi,Kore,4,7,5,16
Hamle,11th,2010,Oromia,Horo Gudru Wellega,Amuru,27,68,92,187
Teqemt,2nd,2010,Oromia,East Wellega,Wayu Tuqa,36,84,94,214
Ginbot,9th,2010,Oromia,West Shewa,Guder Hosp,34,93,34,161
Megabit,7th,2009,Oromia,West Wellega,Boji Dermeji,29,29,52,110
Yekatit,6th,2011,Oromia,Ilu Aba Bora,Hurumu,80,5,12,97
Sene,10th,2009,Oromia,Arsi,Digeluna Tijo,91,49,39,179
Ginbot,9th,2010,Oromia,East Hararge,Bisidimo Hospital,4,59,62,125
Yekatit,6th,2011,Oromia,Woliso Town,Woliso Town,91,86,29,206
Nehase,12th,2009,Oromia,South West Shewa,Wonchi,61,68,88,217
Nehase,12th,2009,Oromia,West Wellega,Lalo Asabi,11,75,18,104
Megabit,7th,2010,Oromia,Arsi,Dodota,46,0,81,127
Hedar,3rd,2010,Oromia,East Hararge,Gole Oda,39,84,34,157
Nehase,12th,2010,Oromia,West Arsi,Kokosa,68,69,32,169
Miyazia,8th,2011,Oromia,West Shewa,Tikur Enchini,6,22,85,113
Sene,10th,2010,Oromia,West Arsi,Adaba,93,26,1,120
Nehase,12th,2010,Oromia,Jimma,Dedo,29,35,86,150
Hedar,3rd,2010,Oromia,Horo Gudru Wellega,Gudru,32,2,48,82
Tir,5th,2011,Oromia,Guji,Dima,3,95,75,173
Meskerem,1st,2011,Oromia,West Wellega,Nejo Rural,9,81,77,167
Ginbot,9th,2010,Oromia,West Wellega,Homa,54,55,44,153
Meskerem,1st,2010,Oromia,North Shewa,Abichugna,86,14,58,158
Sene,10th,2009,Oromia,West Hararge,Daro Lebu,74,11,32,117
Megabit,7th,2010,Oromia,East Hararge,Kurfa Chele,71,20,21,112
Tir,5th,2011,Oromia,North Shewa,Abichugna,94,94,64,252
Megabit,7th,2010,Oromia,Guji,Shakiso Town,50,5,99,154
Tahesas,4th,2010,Oromia,Arsi,Amigna,67,23,56,146
Megabit,7th,2009,Oromia,Bale,Gasera,97,95,38,230
Meskerem,1st,2010,Oromia,Jimma,Shabe,62,60,17,139
Tir,5th,2011,Oromia,Guji,Aga Wayyu,15,21,79,115
Hamle,11th,2010,Oromia,East Hararge,Bedeno,50,11,14,75
Miyazia,8th,2009,Oromia,Qeleme Wellega,Dale Wabera,82,64,69,215
Sene,10th,2009,Oromia,Borena,Yabelo Hospital,47,73,15,135
Yekatit,6th,2010,Oromia,North Shewa,Aleiltu,48,36,32,116
Miyazia,8th,2010,Oromia,West Hararge,Chiro Town,33,7,15,55
Hedar,3rd,2011,Oromia,West Wellega,Lalo Asabi,53,53,13,119
Megabit,7th,2009,Oromia,Buno Bedele,Diga,87,22,10,119
Nehase,12th,2009,Oromia,West Hararge,Boke,60,2,98,160
Tahesas,4th,2011,Oromia,North Shewa,Abichugna,83,44,11,138
Sene,10th,2009,Oromia,Arsi,Bekoji Town,5,12,70,87
Tir,5th,2011,Oromia,Borena,Dilo,12,89,37,138
Megabit,7th,2010,Oromia,West Hararge,Meiso,29,62,52,143
Yekatit,6th,2009,Oromia,North Shewa,Dera Hospital,88,54,95,237
Yekatit,6th,2010,Oromia,East Shewa,Batu,3,83,48,134
Sene,10th,2010,Oromia,Qeleme Wellega,Hawa Gelan,67,75,66,208
Hedar,3rd,2011,Oromia,Woliso Town,Woliso Town,83,51,51,185
Tir,5th,2011,Oromia,West Hararge,West Harerge	Gumbi Bordede,26,53,2,81
Teqemt,2nd,2011,Oromia,East Shewa,Dugda,34,47,7,88
Nehase,12th,2009,Oromia,East Hararge,Goro Muti,46,14,41,101
Tir,5th,2011,Oromia,Horo Gudru Wellega,Horro Buluk,84,23,94,201
Hamle,11th,2009,Oromia,North Shewa,Abichugna,37,50,75,162
Ginbot,9th,2009,Oromia,Jimma,B/Tolyi,11,90,21,122
Ginbot,9th,2009,Oromia,Ilu Aba Bora,Hurumu,43,59,99,201
Miyazia,8th,2009,Oromia,East Wellega,Gudeyabila,60,14,17,91
Yekatit,6th,2010,Oromia,Ilu Aba Bora,Becho,69,47,11,127
Tahesas,4th,2010,Oromia,West Arsi,Bishan Guracha Town,67,55,88,210
Sene,10th,2011,Oromia,Arsi,Shenan Kolu,56,42,80,178
Hedar,3rd,2011,Oromia,Finfine Zuria,Mullo,3,42,83,128
Yekatit,6th,2010,Oromia,West Guji,Hanbala,87,20,26,133
Meskerem,1st,2011,Oromia,West Guji,Suro Barguda,18,3,38,59
Sene,10th,2011,Oromia,East Shewa,Lomme,14,89,64,167
Ginbot,9th,2010,Oromia,West Wellega,Nejo Hospital,67,75,72,214
Sene,10th,2010,Oromia,Horo Gudru Wellega,Abay Chomen,96,82,45,223
Miyazia,8th,2009,Oromia,West Shewa,Ejersa Lafo,56,14,19,89
Sene,10th,2011,Oromia,East Wellega,Kiremu,3,45,8,56
Teqemt,2nd,2011,Oromia,West Hararge,Hawi Gudina,98,29,52,179
Tir,5th,2011,Oromia,Jimma,Guma,30,1,97,128
Megabit,7th,2011,Oromia,Bale,Goro,98,11,1,110
Teqemt,2nd,2011,Oromia,West Shewa,Meta Waliqite,65,46,11,122
Miyazia,8th,2010,Oromia,North Shewa,Were Jarso,27,35,96,158
Megabit,7th,2011,Oromia,North Shewa,Wuchale,44,96,40,180
Nehase,12th,2009,Oromia,Bale,Dawe Qachen,37,41,45,123
Ginbot,9th,2009,Oromia,West Wellega,Gimbi Public  Hospital,0,8,65,73
Ginbot,9th,2009,Oromia,West Shewa,Jeldu,72,45,79,196
Sene,10th,2010,Oromia,East Wellega,Nunu Qumba,17,0,85,102
Tir,5th,2010,Oromia,Borena,Arero,83,34,25,142
Miyazia,8th,2011,Oromia,Borena,Meyo,90,46,80,216
Sene,10th,2010,Oromia,Qeleme Wellega,Dale Wabera,79,61,45,185
Yekatit,6th,2009,Oromia,Horo Gudru Wellega,Jima Geneti,16,98,58,172
Tir,5th,2011,Oromia,West Shewa,Guder Hosp,39,11,87,137
Megabit,7th,2010,Oromia,West Arsi,Dodola  Hospital,13,61,14,88
Teqemt,2nd,2011,Oromia,Arsi,Deksis,96,75,44,215
Meskerem,1st,2011,Oromia,West Wellega,Mene Sibu,81,96,63,240
Miyazia,8th,2010,Oromia,Adama Special Town,Adama Town,40,37,99,176
Teqemt,2nd,2011,Oromia,Qeleme Wellega,Jimma Horo,88,56,12,156
Ginbot,9th,2011,Oromia,East Hararge,Deder,14,55,68,137
Megabit,7th,2011,Oromia,West Guji,Hanbala,48,78,55,181
Sene,10th,2011,Oromia,Finfine Zuria,Mullo,40,57,96,193
Hamle,11th,2009,Oromia,West Wellega,Guliso,98,97,39,234
Megabit,7th,2010,Oromia,East Hararge,Haromaya Town,62,6,11,79
Teqemt,2nd,2011,Oromia,South West Shewa,Ameya Hospital,84,10,39,133
Tahesas,4th,2011,Oromia,Ilu Aba Bora,Ale,54,65,84,203
Teqemt,2nd,2011,Oromia,Borena,Gomole,91,10,83,184
Tahesas,4th,2011,Oromia,Horo Gudru Wellega,Jima Rare,70,13,89,172
Sene,10th,2009,Oromia,Jimma,Omonada,67,67,44,178
Teqemt,2nd,2011,Oromia,West Arsi,Gambo Hospital,43,95,51,189
Yekatit,6th,2010,Oromia,East Wellega,Guto Gida,27,40,74,141
Yekatit,6th,2010,Oromia,East Hararge,Fedis,8,44,3,55
Nehase,12th,2010,Oromia,Borena,Dhas,51,69,91,211
Nehase,12th,2010,Oromia,Jimma,Limu Seka,30,55,66,151
Miyazia,8th,2011,Oromia,Gelan Town,Gelan Town,3,67,17,87
Nehase,12th,2009,Oromia,Borena,Dilo,47,51,34,132
Megabit,7th,2010,Oromia,East Hararge,Haromaya Rural,92,10,53,155
Sene,10th,2011,Oromia,Jimma,Kersa,41,20,25,86
Tir,5th,2010,Oromia,Buno Bedele,Chewaqa,62,98,31,191
Sene,10th,2010,Oromia,Assela Town,Assela Town,18,96,60,174
Hedar,3rd,2011,Oromia,West Wellega,Guliso,36,41,57,134
Ginbot,9th,2009,Oromia,North Shewa,Jido,39,16,79,134
Nehase,12th,2009,Oromia,West Hararge,Meiso,47,18,81,146
Miyazia,8th,2009,Oromia,West Hararge,Meiso,74,90,95,259
Yekatit,6th,2010,Oromia,East Shewa,Dugda,69,16,82,167
Sene,10th,2010,Oromia,Jimma,Limu Kosa,65,2,27,94
Megabit,7th,2010,Oromia,Ilu Aba Bora,Yayu,48,18,71,137
Tahesas,4th,2010,Oromia,Arsi,Chole,66,11,44,121
Meskerem,1st,2010,Oromia,West Wellega,Yubdo,8,82,31,121
Tir,5th,2009,Oromia,Guji,Adola Reda,49,45,87,181
Hedar,3rd,2010,Oromia,East Wellega,Gida Ayana,65,49,61,175
Miyazia,8th,2009,Oromia,Guji,Adola Town,40,3,0,43
Sene,10th,2011,Oromia,West Arsi,Arsi Negele Town,3,67,86,156
Megabit,7th,2011,Oromia,West Arsi,Nensebo,35,61,25,121
Megabit,7th,2009,Oromia,Guji,Adola Town,84,11,66,161
Ginbot,9th,2010,Oromia,East Hararge,Babile,62,21,49,132
Megabit,7th,2010,Oromia,East Wellega,Boneya Bushe,55,33,36,124
Hamle,11th,2009,Oromia,West Wellega,Nole Kaba,32,83,17,132
Hamle,11th,2010,Oromia,Ilu Aba Bora,Hurumu,31,53,24,108
Miyazia,8th,2010,Oromia,South West Shewa,Seden Sodo,59,97,25,181
Megabit,7th,2010,Oromia,East Shewa,Batu,75,15,60,150
Meskerem,1st,2010,Oromia,North Shewa,Girar Jarso,79,91,66,236
Meskerem,1st,2011,Oromia,East Hararge,Kersa Eh,75,28,60,163
Ginbot,9th,2009,Oromia,West Wellega,Begi,71,21,23,115
Tir,5th,2011,Oromia,West Guji,Hanbala,90,27,85,202
Ginbot,9th,2009,Oromia,South West Shewa,Dawo,59,59,15,133
Hamle,11th,2009,Oromia,Guji,Shakiso Town,21,40,24,85
Ginbot,9th,2011,Oromia,West Hararge,Gelemso Hospital,84,52,29,165
Tahesas,4th,2011,Oromia,Jimma,O/Beyam,38,32,39,109
Megabit,7th,2010,Oromia,East Hararge,Haromaya Rural,82,18,5,105
Hamle,11th,2010,Oromia,Arsi,Enkelo Wabe,45,87,61,193
Hedar,3rd,2010,Oromia,East Wellega,Wayu Tuqa,29,61,23,113
Tir,5th,2011,Oromia,South West Shewa,Ameya Hospital,35,87,13,135
Teqemt,2nd,2010,Oromia,West Shewa,Ejersa Lafo,62,54,69,185
Hedar,3rd,2011,Oromia,West Hararge,Tulo,13,11,89,113
Miyazia,8th,2011,Oromia,Jimma,Kersa,39,92,72,203
Tir,5th,2010,Oromia,West Wellega,Lata Sibu,8,61,5,74
Ginbot,9th,2009,Oromia,North Shewa,Abichugna,92,68,43,203
Megabit,7th,2010,Oromia,East Hararge,Kombolicha,46,73,22,141
Yekatit,6th,2010,Oromia,Borena,Gomole,98,24,36,158
Ginbot,9th,2011,Oromia,East Hararge,Babile,57,24,73,154
Ginbot,9th,2010,Oromia,West Arsi,Wondo,39,10,6,55
Ginbot,9th,2010,Oromia,Qeleme Wellega,Dambi Dollo,79,95,86,260
Miyazia,8th,2010,Oromia,Jimma,Dedo,64,52,88,204
Tir,5th,2010,Oromia,East Hararge,Goro Muti,63,81,16,160
Meskerem,1st,2011,Oromia,West Wellega,Nejo Hospital,64,44,88,196
Tahesas,4th,2011,Oromia,East Hararge,Deder Hospital,4,49,94,147
Yekatit,6th,2011,Oromia,North Shewa,Dera,97,11,62,170
Nehase,12th,2009,Oromia,West Shewa,Ambo Town,69,77,75,221
Nehase,12th,2010,Oromia,East Shewa,Batu,25,94,79,198
Hedar,3rd,2010,Oromia,Jimma,Gera,42,59,49,150
Tir,5th,2011,Oromia,East Wellega,Gobu Seyo,52,77,95,224
Meskerem,1st,2010,Oromia,West Wellega,Yubdo,17,5,87,109
Hamle,11th,2009,Oromia,West Shewa,Ambo Hospital,81,99,76,256
Ginbot,9th,2010,Oromia,Jimma,Limu Seka,10,66,36,112
Megabit,7th,2011,Oromia,Borena,Guchi,56,84,24,164
Miyazia,8th,2011,Oromia,Qeleme Wellega,Jimma Horo,39,74,92,205
Hamle,11th,2010,Oromia,Bale,Ginir,65,3,63,131
Yekatit,6th,2010,Oromia,Qeleme Wellega,Seyo,73,31,86,190
Tahesas,4th,2011,Oromia,East Shewa,Adami Tulu Jido Kombolcha,78,84,30,192
Ginbot,9th,2010,Oromia,West Hararge,Anchar,59,30,29,118
Hedar,3rd,2010,Oromia,Buno Bedele,Chora,5,17,44,66
Tahesas,4th,2011,Oromia,North Shewa,Debre Libanos,37,18,5,60
Sene,10th,2010,Oromia,Arsi,Tena,16,47,33,96
Hedar,3rd,2010,Oromia,West Guji,Bule Hora Hospital,77,63,4,144
Sene,10th,2010,Oromia,East Shewa,Matahara,8,96,86,190
Yekatit,6th,2009,Oromia,Borena,Dubluk,53,71,59,183
Tahesas,4th,2010,Oromia,East Wellega,Ebantu,92,59,24,175
Hamle,11th,2009,Oromia,Jimma,Chora Boter,74,97,36,207
Teqemt,2nd,2011,Oromia,Guji,Hambela Wamena,3,77,78,158
Tir,5th,2011,Oromia,Ilu Aba Bora,Ale,54,95,20,169
Teqemt,2nd,2010,Oromia,East Hararge,Jarso,27,13,8,48
Hedar,3rd,2011,Oromia,Borena,Moyale Hospital,76,87,3,166
Tir,5th,2009,Oromia,South West Shewa,Ameya,9,51,24,84
Miyazia,8th,2011,Oromia,West Guji,Suro Barguda,19,33,51,103
Yekatit,6th,2010,Oromia,Horo Gudru Wellega,Jarte Jardga,37,91,48,176
Nehase,12th,2009,Oromia,Borena,Dhas,95,79,21,195
Miyazia,8th,2010,Oromia,Ilu Aba Bora,Metu Town,23,7,61,91
Meskerem,1st,2011,Oromia,East Shewa,Lomme,83,75,5,163
Ginbot,9th,2010,Oromia,West Shewa,Abuna Gindeberet,70,56,98,224
Hamle,11th,2010,Oromia,West Wellega,Mendi Town,10,63,5,78
Megabit,7th,2011,Oromia,Bale,Arena Buluq,46,57,1,104
Megabit,7th,2009,Oromia,South West Shewa,Woliso Town,95,19,89,203
Tir,5th,2009,Oromia,West Wellega,Genji,75,16,40,131
Hedar,3rd,2011,Oromia,West Wellega,Gimbi,97,99,7,203
Megabit,7th,2010,Oromia,West Shewa,Elifata,60,12,4,76
Hamle,11th,2009,Oromia,East Wellega,Limu,51,45,75,171
Megabit,7th,2010,Oromia,South West Shewa,Kersana Malima,85,32,84,201
Hedar,3rd,2011,Oromia,Bale,Goba Town,22,90,44,156
Megabit,7th,2011,Oromia,Guji,Gumi Eldallo,97,75,84,256
Yekatit,6th,2010,Oromia,Qeleme Wellega,Sedan Chanka,81,64,3,148
Tahesas,4th,2010,Oromia,West Hararge,Anchar,94,31,21,146
Miyazia,8th,2010,Oromia,West Wellega,Nejo Hospital,16,59,71,146
Tahesas,4th,2010,Oromia,Arsi,Limuna Bilbilo,4,8,56,68
Tahesas,4th,2010,Oromia,Guji,Shakiso Town,51,38,47,136
Miyazia,8th,2009,Oromia,West Shewa,Ambo,70,89,77,236
Teqemt,2nd,2010,Oromia,Buno Bedele,Chewaqa,0,12,14,26
Nehase,12th,2010,Oromia,South West Shewa,St.Luke Hospital,6,2,27,35
Megabit,7th,2009,Oromia,Arsi,Enkelo Wabe,15,96,16,127
Hedar,3rd,2011,Oromia,East Hararge,Goro Gutu,96,47,92,235
Nehase,12th,2010,Oromia,Arsi,Chole,51,17,33,101
Ginbot,9th,2009,Oromia,East Hararge,Fedis,71,84,74,229
Nehase,12th,2009,Oromia,Bishoftu Town,Bishoftu Town,74,70,25,169
Megabit,7th,2011,Oromia,Ambo Town,Ambo Town,75,18,20,113
Sene,10th,2010,Oromia,West Wellega,Nole Kaba,57,22,65,144
Teqemt,2nd,2011,Oromia,South West Shewa,Tulu Bolo Hospital,4,99,46,149
Sene,10th,2009,Oromia,West Arsi,Kore,51,3,58,112
Sene,10th,2010,Oromia,East Hararge,Haromaya Town,74,33,25,132
Tahesas,4th,2010,Oromia,Arsi,Tena,2,79,6,87
Meskerem,1st,2011,Oromia,South West Shewa,Ilu,18,41,6,65
Nehase,12th,2009,Oromia,Ilu Aba Bora,Doreni,29,10,76,115
Tir,5th,2010,Oromia,Qeleme Wellega,Hawa Gelan,15,92,94,201
Megabit,7th,2010,Oromia,South West Shewa,Dawo,86,51,38,175
Miyazia,8th,2009,Oromia,West Shewa,Tibe Kutaye,88,20,81,189
Sene,10th,2009,Oromia,East Hararge,Midega Tole,13,50,32,95
Hedar,3rd,2011,Oromia,West Shewa,Bako Hospital,66,66,97,229
Hedar,3rd,2010,Oromia,South West Shewa,Woliso Rural,90,48,56,194
Meskerem,1st,2011,Oromia,Arsi,Munesa,79,23,15,117
Nehase,12th,2010,Oromia,Nekemte Town,Nekemte Town,95,68,5,168
Teqemt,2nd,2010,Oromia,East Hararge,Kumbi,66,91,71,228
Yekatit,6th,2009,Oromia,East Hararge,Garemuleta Hospital,45,78,92,215
Sene,10th,2009,Oromia,West Arsi,Kore,6,37,26,69
Megabit,7th,2011,Oromia,South West Shewa,Sodo Dac'Ha,82,36,73,191
Ginbot,9th,2009,Oromia,Horo Gudru Wellega,Hababo Guduru,69,94,89,252
Ginbot,9th,2010,Oromia,Buno Bedele,Bedele Town,11,5,14,30
Nehase,12th,2009,Oromia,West Guji,Dugda Dawa,89,88,35,212
Hamle,11th,2010,Oromia,West Arsi,Kore,32,76,50,158
Ginbot,9th,2010,Oromia,Borena,Wachile,20,12,13,45
Yekatit,6th,2010,Oromia,West Wellega,Mene Sibu,60,61,43,164
Nehase,12th,2009,Oromia,Arsi,Tiyo,53,27,95,175
Meskerem,1st,2010,Oromia,West Wellega,Boji Dermeji,8,17,28,53
Meskerem,1st,2010,Oromia,West Wellega,Nejo Hospital,18,99,9,126
Nehase,12th,2010,Oromia,Jimma,Mana,99,14,64,177
Ginbot,9th,2009,Oromia,Bale,Dawe Serar,14,77,79,170
Hedar,3rd,2011,Oromia,Arsi,Munesa,33,54,70,157
Megabit,7th,2011,Oromia,South West Shewa,Sodo Dac'Ha,21,93,71,185
Megabit,7th,2009,Oromia,West Wellega,Gimbi Rural,35,55,28,118
Yekatit,6th,2010,Oromia,Adama Special Town,Adama Town,9,71,83,163
Yekatit,6th,2009,Oromia,West Wellega,Gimbi,56,45,70,171
Teqemt,2nd,2010,Oromia,Borena,Meyo,3,78,5,86
Megabit,7th,2011,Oromia,East Wellega,Gudeyabila,57,78,17,152
Ginbot,9th,2010,Oromia,Borena,Dhas,95,32,47,174
Ginbot,9th,2009,Oromia,Jimma,B/Tolyi,18,88,82,188
Meskerem,1st,2010,Oromia,East Hararge,Kurfa Chele,65,49,87,201
Tir,5th,2010,Oromia,West Wellega,Mendi Town,23,2,59,84
Teqemt,2nd,2010,Oromia,West Arsi,Wondo,32,75,80,187
Hedar,3rd,2010,Oromia,Borena,El Way,72,33,38,143
Meskerem,1st,2010,Oromia,Arsi,Robe,9,80,57,146
Hamle,11th,2009,Oromia,West Shewa,Chelia,85,16,23,124
Meskerem,1st,2010,Oromia,Jimma,Limu Seka,25,38,89,152
Ginbot,9th,2011,Oromia,Arsi,Munesa,50,48,56,154
Hamle,11th,2010,Oromia,West Hararge,Daro Lebu,91,3,67,161
Tahesas,4th,2010,Oromia,Finfine Zuria,Mullo,94,10,18,122
Nehase,12th,2010,Oromia,Burayu Town,Burayu Town,91,34,81,206
Yekatit,6th,2009,Oromia,Bale,Ginir Town,71,27,55,153
Sene,10th,2010,Oromia,East Hararge,Gursum,82,12,5,99
Yekatit,6th,2009,Oromia,Guji,Shakiso Town,98,58,22,178
Miyazia,8th,2010,Oromia,Borena,El Way,60,26,60,146
Yekatit,6th,2010,Oromia,East Hararge,Gursum,7,14,88,109
Nehase,12th,2010,Oromia,Jimma,Dedo,87,34,48,169
Nehase,12th,2009,Oromia,Horo Gudru Wellega,Horo,19,69,84,172
Ginbot,9th,2009,Oromia,Qeleme Wellega,Gawo Qebe,43,14,83,140
Ginbot,9th,2011,Oromia,West Hararge,Guba Qoricha,56,67,11,134
Tahesas,4th,2011,Oromia,East Wellega,Wama Hagelo,6,20,53,79
Yekatit,6th,2009,Oromia,Borena,Dire,27,94,40,161
Meskerem,1st,2011,Oromia,Guji,Bore,80,42,48,170
Megabit,7th,2009,Oromia,West Wellega,Jarso,69,0,89,158
Tir,5th,2011,Oromia,West Hararge,Meiso,98,80,98,276
Megabit,7th,2010,Oromia,South West Shewa,Goro,19,60,26,105
Megabit,7th,2011,Oromia,Arsi,Enkelo Wabe,47,67,22,136
Ginbot,9th,2010,Oromia,West Shewa,Tibe Kutaye,59,99,4,162
Hamle,11th,2010,Oromia,Ilu Aba Bora,Algesachi,37,91,98,226
Nehase,12th,2009,Oromia,Guji,Dima,53,43,80,176
Hamle,11th,2010,Oromia,Bale,Dawe Serar,36,11,30,77
Tahesas,4th,2010,Oromia,West Wellega,Guliso,20,18,72,110
Tahesas,4th,2010,Oromia,Ilu Aba Bora,Yayu,8,23,71,102
Sene,10th,2009,Oromia,North Shewa,Wuchale,19,67,46,132
Miyazia,8th,2010,Oromia,East Hararge,Jarso,85,64,63,212
Megabit,7th,2011,Oromia,East Hararge,Girawa,79,26,71,176
Sene,10th,2010,Oromia,Borena,Gomole,69,51,95,215
Miyazia,8th,2011,Oromia,Borena,Yabelo,65,56,91,212
Yekatit,6th,2011,Oromia,North Shewa,Kimbibit,65,96,82,243
Yekatit,6th,2009,Oromia,South West Shewa,Sodo Dac'Ha,47,19,81,147
Nehase,12th,2010,Oromia,Finfine Zuria,Berreh,41,32,88,161
Tir,5th,2011,Oromia,Qeleme Wellega,Anfilo,9,50,1,60
Miyazia,8th,2011,Oromia,West Hararge,Guba Qoricha,91,72,39,202
Teqemt,2nd,2011,Oromia,Finfine Zuria,Sululta Town,77,55,23,155
Tir,5th,2011,Oromia,East Hararge,Chinakesen,55,58,19,132
Tahesas,4th,2011,Oromia,East Hararge,Babile,71,56,33,160
Megabit,7th,2009,Oromia,West Wellega,Begi Hospital,57,4,66,127
Teqemt,2nd,2010,Oromia,East Hararge,Kurfa Chele,77,42,37,156
Hamle,11th,2010,Oromia,Jimma,Dedo,51,38,21,110
Sene,10th,2009,Oromia,West Wellega,Nejo Hospital,94,83,93,270
Sene,10th,2010,Oromia,East Wellega,Haro Limu,43,18,92,153
Hedar,3rd,2010,Oromia,Arsi,Deksis,87,5,98,190
Meskerem,1st,2011,Oromia,Buno Bedele,Bedele Hospital,6,23,15,44
Tahesas,4th,2011,Oromia,North Shewa,Hidabu Abote,0,77,84,161
Teqemt,2nd,2010,Oromia,West Wellega,Mendi Hospital,36,40,22,98
Megabit,7th,2011,Oromia,East Shewa,Dugda,91,42,38,171
Ginbot,9th,2011,Oromia,Bale,Delo Mena,91,50,79,220
Meskerem,1st,2011,Oromia,Borena,Gomole,82,91,38,211
Meskerem,1st,2010,Oromia,Borena,Gomole,89,27,87,203
Hamle,11th,2009,Oromia,Ilu Aba Bora,Ale,49,51,91,191
Meskerem,1st,2010,Oromia,West Guji,Bule Hora Hospital,32,14,7,53
Miyazia,8th,2011,Oromia,Dukem Town,Dukem Town,17,26,69,112
Ginbot,9th,2010,Oromia,Arsi,Digeluna Tijo,17,81,16,114
Ginbot,9th,2009,Oromia,West Hararge,West Harerge	Gumbi Bordede,62,33,96,191
Yekatit,6th,2011,Oromia,Bale,Goro,40,23,55,118
Sene,10th,2010,Oromia,West Shewa,Ambo Hospital,57,36,77,170
Sene,10th,2010,Oromia,West Arsi,Wondo,19,72,28,119
Megabit,7th,2011,Oromia,Finfine Zuria,Walmera,66,56,73,195
Nehase,12th,2009,Oromia,North Shewa,Abichugna,97,8,85,190
Ginbot,9th,2010,Oromia,East Hararge,Midega Tole,22,45,97,164
Hedar,3rd,2010,Oromia,East Hararge,Garemuleta Hospital,34,11,0,45
Ginbot,9th,2011,Oromia,Jimma,Agaro,44,64,60,168
Nehase,12th,2009,Oromia,North Shewa,Abichugna,79,60,29,168
Ginbot,9th,2011,Oromia,Qeleme Wellega,Gidami,2,44,84,130
Teqemt,2nd,2010,Oromia,Guji,Odo Shakiso,69,14,84,167
Miyazia,8th,2010,Oromia,Finfine Zuria,Akaki,38,17,98,153
Sene,10th,2010,Oromia,West Arsi,Kokosa,70,52,85,207
Megabit,7th,2011,Oromia,Ilu Aba Bora,Bure,90,94,32,216
Meskerem,1st,2011,Oromia,East Hararge,Bedeno,20,84,76,180
Hamle,11th,2010,Oromia,North Shewa,Fichetown,32,62,90,184
Yekatit,6th,2009,Oromia,North Shewa,Hidabu Abote,14,73,94,181
Tir,5th,2011,Oromia,Guji,Negele Hospital,47,41,99,187
Yekatit,6th,2009,Oromia,Bale,Delo Mena,34,7,74,115
Megabit,7th,2011,Oromia,Sululta Town,Sululta Town,23,34,76,133
Megabit,7th,2010,Oromia,Buno Bedele,Diga,36,47,65,148
Sene,10th,2011,Oromia,Sululta Town,Sululta Town,83,74,60,217
Hamle,11th,2009,Oromia,East Wellega,Boneya Bushe,70,62,42,174
Meskerem,1st,2011,Oromia,West Shewa,Gindeberet Hospital,42,50,6,98
Hedar,3rd,2011,Oromia,Ilu Aba Bora,Metu Rural,30,97,21,148
Yekatit,6th,2009,Oromia,West Hararge,West Harerge	Gumbi Bordede,45,63,80,188
Tir,5th,2010,Oromia,Bale,Goba Town,94,81,1,176
Megabit,7th,2010,Oromia,South West Shewa,Dawo,60,81,98,239
Hedar,3rd,2010,Oromia,Bale,Legehida,82,94,42,218
Nehase,12th,2010,Oromia,West Shewa,Gindeberet Hospital,91,30,51,172
Sene,10th,2009,Oromia,Borena,Wachile,23,19,11,53
Megabit,7th,2009,Oromia,West Wellega,Ayira Hospital,23,97,85,205
Tahesas,4th,2011,Oromia,Arsi,Merti,52,43,98,193
Sene,10th,2009,Oromia,West Arsi,Shala,16,81,46,143
Hedar,3rd,2011,Oromia,Arsi,Ludehetosa,47,9,92,148
Sene,10th,2009,Oromia,Jimma,Shabe,30,62,13,105
Meskerem,1st,2010,Oromia,Jimma,Chora Boter,8,7,36,51
Teqemt,2nd,2011,Oromia,Bale,Ginir Town,84,87,98,269
Miyazia,8th,2011,Oromia,Nekemte Town,Nekemte Town,62,21,7,90
Nehase,12th,2009,Oromia,West Arsi,Dodola Rural,51,18,15,84
Yekatit,6th,2009,Oromia,East Hararge,Deder,28,49,27,104
Hamle,11th,2010,Oromia,Arsi,Tena,95,57,1,153
Tir,5th,2009,Oromia,North Shewa,Jido,61,99,40,200
Tir,5th,2011,Oromia,West Arsi,Shashemene Rural,18,87,94,199
Hamle,11th,2009,Oromia,East Hararge,Garemuleta Hospital,75,88,1,164
Nehase,12th,2010,Oromia,Jimma,Mancho,30,88,62,180
Meskerem,1st,2011,Oromia,East Hararge,Haromaya Hospital,25,30,17,72
Hedar,3rd,2010,Oromia,West Guji,Dugda Dawa,62,3,79,144
Sene,10th,2010,Oromia,West Arsi,Shala,31,42,13,86
Tir,5th,2009,Oromia,East Hararge,Meyu Muleke,40,85,39,164
Hamle,11th,2009,Oromia,West Shewa,Guder Hosp,74,74,46,194
Nehase,12th,2010,Oromia,North Shewa,Kimbibit,37,51,5,93
Nehase,12th,2009,Oromia,East Hararge,Gole Oda,79,0,5,84
Meskerem,1st,2010,Oromia,Arsi,Guna,56,45,37,138
Tahesas,4th,2011,Oromia,East Hararge,Midega Tole,45,20,82,147
Hedar,3rd,2011,Oromia,Arsi,Aseko,63,24,32,119
Sene,10th,2010,Oromia,Jimma,Limu Kosa,1,79,93,173
Yekatit,6th,2009,Oromia,West Arsi,Shala,73,60,16,149
Megabit,7th,2009,Oromia,East Shewa,Batu,61,76,84,221
Tir,5th,2009,Oromia,West Guji,Kercha Hospital,66,24,95,185
Tir,5th,2009,Oromia,Arsi,Amigna,0,51,11,62
Teqemt,2nd,2010,Oromia,East Hararge,Haromaya Hospital,50,98,91,239
Sene,10th,2011,Oromia,Borena,Teltele,93,6,0,99
Tir,5th,2011,Oromia,Arsi,Jeju,6,56,23,85
Miyazia,8th,2011,Oromia,West Hararge,Habro,67,53,59,179
Hedar,3rd,2011,Oromia,Qeleme Wellega,Kake Hosp,97,66,90,253
Yekatit,6th,2009,Oromia,West Shewa,Meta Waliqite,34,10,54,98
Hamle,11th,2009,Oromia,West Hararge,Hawi Gudina,13,52,76,141
Tahesas,4th,2010,Oromia,North Shewa,Aleiltu,60,76,43,179
Sene,10th,2009,Oromia,Horo Gudru Wellega,Gudru,10,82,6,98
Yekatit,6th,2009,Oromia,Qeleme Wellega,Gawo Qebe,63,23,98,184
Tir,5th,2010,Oromia,North Shewa,Abichugna,22,13,46,81
Tahesas,4th,2010,Oromia,Adama Special Town,Adama Town,66,36,84,186
Ginbot,9th,2011,Oromia,West Guji,Bule Hora Toun,25,86,50,161
Miyazia,8th,2009,Oromia,West Wellega,Boji Dermeji,97,76,74,247
Ginbot,9th,2011,Oromia,North Shewa,Kimbibit,22,21,5,48
Yekatit,6th,2011,Oromia,West Wellega,Begi Hospital,32,87,35,154
Meskerem,1st,2011,Oromia,Ilu Aba Bora,Darimu,98,48,86,232
Nehase,12th,2010,Oromia,Jimma,Omonada,1,27,76,104
Hedar,3rd,2011,Oromia,Qeleme Wellega,Dale Wabera,49,90,17,156
Tir,5th,2010,Oromia,Jimma,Sigmo,24,85,6,115
Sene,10th,2009,Oromia,Guji,Gumi Eldallo,92,27,15,134
Teqemt,2nd,2011,Oromia,Arsi,Merti,26,7,5,38
Megabit,7th,2010,Oromia,Qeleme Wellega,Gidami,71,90,28,189
Megabit,7th,2010,Oromia,Guji,Gumi Eldallo,15,64,47,126
Tahesas,4th,2011,Oromia,West Shewa,Codi,93,61,48,202
Yekatit,6th,2011,Oromia,Guji,Girja,46,0,31,77
Hamle,11th,2009,Oromia,South West Shewa,Tole,90,11,83,184
Tahesas,4th,2011,Oromia,East Shewa,Adami Tulu Jido Kombolcha,48,43,72,163
Hedar,3rd,2011,Oromia,East Shewa,Adea,29,81,28,138
Tir,5th,2011,Oromia,Jimma,Omonada,18,51,73,142
Miyazia,8th,2011,Oromia,Arsi,Merti,41,75,13,129
Meskerem,1st,2011,Oromia,Horo Gudru Wellega,Shambu Hospital,76,96,58,230
Yekatit,6th,2011,Oromia,Qeleme Wellega,Gidami,10,99,57,166
Sene,10th,2010,Oromia,East Hararge,Meyu Muleke,79,17,41,137
Nehase,12th,2010,Oromia,West Arsi,Arsi Negele Rural,7,82,35,124
Tir,5th,2009,Oromia,Bale,Robe Town,96,84,99,279
Hedar,3rd,2010,Oromia,West Shewa,Bako Tibe,97,21,48,166
Yekatit,6th,2009,Oromia,West Guji,Abaya,51,59,8,118
Megabit,7th,2009,Oromia,South West Shewa,Ameya,71,4,45,120
Hamle,11th,2009,Oromia,Guji,Girja,62,96,58,216
Meskerem,1st,2010,Oromia,West Arsi,Kokosa,8,3,83,94
Teqemt,2nd,2011,Oromia,West Guji,Dugda Dawa,63,92,79,234
Miyazia,8th,2010,Oromia,Bale,Legehida,34,78,38,150
Ginbot,9th,2010,Oromia,Bale,Raitu,10,63,0,73
Miyazia,8th,2010,Oromia,West Wellega,Boji Dermeji,66,13,91,170
Ginbot,9th,2010,Oromia,Ilu Aba Bora,Metu Rural,33,86,18,137
Tahesas,4th,2011,Oromia,Arsi,Amigna,60,13,84,157
Ginbot,9th,2009,Oromia,North Shewa,Yaya Gulele,32,65,95,192
Hedar,3rd,2011,Oromia,West Shewa,Abuna Gindeberet,54,30,65,149
Sene,10th,2009,Oromia,Shashamane Town,Shashamane Town,20,71,58,149
Meskerem,1st,2010,Oromia,Arsi,Aseko,85,58,41,184
Nehase,12th,2010,Oromia,Buno Bedele,Bedele Hospital,18,79,53,150
Hamle,11th,2010,Oromia,West Shewa,Midakegni,19,54,65,138
Hedar,3rd,2011,Oromia,Jimma,Sekoru,27,39,44,110
Sene,10th,2011,Oromia,East Hararge,Goro Gutu,11,10,51,72
Ginbot,9th,2010,Oromia,Arsi,Dodota,23,6,34,63
Nehase,12th,2010,Oromia,Arsi,Jeju,80,49,23,152
Tir,5th,2011,Oromia,Buno Bedele,Diga,43,26,3,72
Ginbot,9th,2011,Oromia,Jimma,Kersa,13,67,60,140
Tir,5th,2011,Oromia,West Wellega,Jarso,85,98,0,183
Nehase,12th,2009,Oromia,East Hararge,Garemuleta Hospital,53,47,37,137
Teqemt,2nd,2011,Oromia,West Wellega,Ayira,80,24,32,136
Megabit,7th,2011,Oromia,Guji,Hambela Wamena,4,18,49,71
Tir,5th,2011,Oromia,West Hararge,Gelemso Hospital,50,28,45,123
Megabit,7th,2010,Oromia,North Shewa,Kuyu,12,60,85,157
Tir,5th,2011,Oromia,North Shewa,Yaya Gulele,59,72,58,189
Ginbot,9th,2011,Oromia,Jimma,O/Beyam,33,28,47,108
Nehase,12th,2009,Oromia,Guji,Liben,16,70,70,156
Sene,10th,2009,Oromia,Jimma,Setema,96,3,56,155
Hedar,3rd,2010,Oromia,West Wellega,Qiltu Kara,51,26,68,145
Ginbot,9th,2011,Oromia,Guji,Adola Reda,43,39,74,156
Hedar,3rd,2011,Oromia,Guji,Girja,38,53,3,94
Nehase,12th,2010,Oromia,Jimma,Setema,89,28,89,206
Tir,5th,2009,Oromia,West Shewa,Ilu Galan,29,30,50,109
Hedar,3rd,2011,Oromia,West Shewa,Guder Hosp,80,90,54,224
Yekatit,6th,2010,Oromia,Bale,Sinana,42,86,5,133
Sene,10th,2009,Oromia,West Wellega,Homa,63,25,6,94
Teqemt,2nd,2011,Oromia,Borena,Meyo,66,93,50,209
Ginbot,9th,2010,Oromia,Dukem Town,Dukem Town,78,9,59,146
Tahesas,4th,2011,Oromia,Qeleme Wellega,Hawa Gelan,20,89,6,115
Tir,5th,2009,Oromia,West Arsi,Arsi Negele Rural,0,66,79,145
Ginbot,9th,2011,Oromia,East Hararge,Chelenko Hospital,74,26,70,170
Megabit,7th,2009,Oromia,Jimma,Omonada,84,6,63,153
Teqemt,2nd,2011,Oromia,Guji,Gumi Eldallo,77,44,35,156
Ginbot,9th,2010,Oromia,West Shewa,Meta Waliqite,66,39,41,146
Sene,10th,2011,Oromia,West Shewa,Dano,31,87,80,198
Tir,5th,2009,Oromia,Ilu Aba Bora,Ale,66,35,85,186
Megabit,7th,2010,Oromia,West Arsi,Hebal Arsi,94,20,33,147
Tahesas,4th,2010,Oromia,Guji,Wadara,64,76,2,142
Ginbot,9th,2011,Oromia,East Hararge,Girawa,17,85,35,137
Meskerem,1st,2010,Oromia,West Wellega,Ayira Hospital,35,80,89,204
Miyazia,8th,2011,Oromia,West Arsi,Siraro,42,74,90,206
Yekatit,6th,2009,Oromia,West Shewa,Nono,57,64,17,138
Yekatit,6th,2010,Oromia,Finfine Zuria,Sebeta Awas,3,85,48,136
Tahesas,4th,2010,Oromia,Qeleme Wellega,Dambi Dolo Hospital,8,4,53,65
Tahesas,4th,2011,Oromia,East Hararge,Meyu Muleke,92,38,22,152
Nehase,12th,2009,Oromia,Assela Town,Assela Town,68,2,45,115
Sene,10th,2009,Oromia,Guji,Hambela Wamena,11,26,80,117
Miyazia,8th,2011,Oromia,Horo Gudru Wellega,Gudru,25,56,55,136
Tahesas,4th,2011,Oromia,Bishoftu Town,Bishoftu Town,50,48,36,134
Yekatit,6th,2011,Oromia,West Wellega,Nejo Town,61,37,20,118
Sene,10th,2010,Oromia,West Hararge,Burka Dimtu,87,31,38,156
Ginbot,9th,2010,Oromia,Jimma,Mancho,99,36,5,140
Hedar,3rd,2010,Oromia,Borena,El Way,8,59,68,135
Miyazia,8th,2009,Oromia,West Shewa,Adea Berga,87,71,24,182
Hamle,11th,2010,Oromia,South West Shewa,Becho,50,64,64,178
Nehase,12th,2010,Oromia,Borena,Dubluk,28,21,13,62
Sene,10th,2010,Oromia,West Shewa,Midakegni,88,16,66,170
Miyazia,8th,2009,Oromia,Qeleme Wellega,Laloqile,32,77,18,127
Miyazia,8th,2011,Oromia,West Hararge,Hawi Gudina,87,74,8,169
Ginbot,9th,2010,Oromia,West Shewa,Ilu Galan,35,81,30,146
Tir,5th,2010,Oromia,West Shewa,Dendi,74,60,45,179
Sene,10th,2009,Oromia,Finfine Zuria,Berreh,0,29,90,119
Hedar,3rd,2011,Oromia,West Hararge,Daro Lebu,3,68,0,71
Sene,10th,2009,Oromia,South West Shewa,Tole,67,65,51,183
Nehase,12th,2010,Oromia,Ilu Aba Bora,Metu Town,7,11,47,65
Megabit,7th,2011,Oromia,East Shewa,Bora,39,67,2,108
Tir,5th,2011,Oromia,Buno Bedele,Diga,2,12,79,93
Miyazia,8th,2011,Oromia,East Wellega,Diga,85,58,9,152
Tir,5th,2010,Oromia,West Hararge,Boke,58,67,79,204
Tir,5th,2010,Oromia,Bale,Agarfa,90,84,6,180
Nehase,12th,2009,Oromia,Horo Gudru Wellega,Horo,27,0,65,92
Megabit,7th,2010,Oromia,Borena,Dilo,88,33,53,174
Meskerem,1st,2011,Oromia,Qeleme Wellega,Yemalogi Wolel,12,93,52,157
Tahesas,4th,2010,Oromia,Guji,Bore,53,96,32,181
Hamle,11th,2009,Oromia,East Hararge,Fedis,92,44,58,194
Ginbot,9th,2009,Oromia,West Wellega,Yubdo,79,58,49,186
Sene,10th,2010,Oromia,Jimma,Nono Benja,55,77,67,199
Tir,5th,2009,Oromia,West Hararge,Chiro Zuriya,4,87,55,146
Sene,10th,2011,Oromia,Ilu Aba Bora,Doreni,54,16,73,143
Sene,10th,2010,Oromia,Arsi,Guna,17,78,8,103
Megabit,7th,2010,Oromia,West Arsi,Nensebo,63,53,38,154
Sene,10th,2009,Oromia,West Shewa,Liban Jawi,69,71,70,210
Nehase,12th,2009,Oromia,Jimma,B/Tolyi,85,88,69,242
Hedar,3rd,2011,Oromia,East Shewa,Bora,61,27,89,177
Megabit,7th,2011,Oromia,West Guji,Bule Hora,81,51,28,160
Meskerem,1st,2010,Oromia,Guji,Aga Wayyu,65,50,90,205
Megabit,7th,2010,Oromia,West Shewa,Metarobi,1,97,49,147
Ginbot,9th,2009,Oromia,Jimma,Setema,23,21,61,105
Meskerem,1st,2011,Oromia,East Shewa,Fentale,20,76,60,156
Nehase,12th,2010,Oromia,Borena,Teltele,38,87,88,213
Miyazia,8th,2010,Oromia,East Hararge,Chelenko Hospital,19,4,73,96
Hamle,11th,2009,Oromia,Sebeta Town,Sebeta Town,20,26,59,105
Nehase,12th,2009,Oromia,East Wellega,Gudeyabila,60,5,89,154
Sene,10th,2010,Oromia,North Shewa,Hidabu Abote,77,78,56,211
Tir,5th,2011,Oromia,West Shewa,Gindeberet Hospital,64,26,13,103
Tahesas,4th,2011,Oromia,Bale,Dawe Serar,36,1,48,85
Miyazia,8th,2010,Oromia,Horo Gudru Wellega,Abay Chomen,51,36,38,125
Ginbot,9th,2010,Oromia,Bale,Dawe Serar,79,41,72,192
Hamle,11th,2009,Oromia,Arsi,Tena,99,45,29,173
Tir,5th,2010,Oromia,West Shewa,Adea Berga,72,63,87,222
Hamle,11th,2010,Oromia,Bale,Legehida,95,94,16,205
Hedar,3rd,2011,Oromia,Bale,Sinana,36,69,45,150
Tahesas,4th,2010,Oromia,East Wellega,Guto Gida,66,84,39,189
Hedar,3rd,2010,Oromia,Borena,Wachile,19,68,4,91
Hamle,11th,2010,Oromia,Guji,Adola Hospital,67,45,15,127
Hamle,11th,2010,Oromia,West Arsi,Bishan Guracha Town,86,71,61,218
Teqemt,2nd,2011,Oromia,North Shewa,Kuyu Hospital,0,61,97,158
Teqemt,2nd,2011,Oromia,Guji,Adola Hospital,13,29,74,116
Tahesas,4th,2010,Oromia,West Wellega,Mene Sibu,74,66,25,165
Hamle,11th,2010,Oromia,North Shewa,Fichetown,40,69,25,134
Tir,5th,2009,Oromia,Arsi,Bekoji Town,14,61,57,132
Tir,5th,2009,Oromia,West Hararge,Burka Dimtu,38,63,71,172
Megabit,7th,2010,Oromia,West Shewa,Inchini Hospital,57,48,2,107
Meskerem,1st,2011,Oromia,West Wellega,Gimbi Rural,46,30,88,164
Teqemt,2nd,2010,Oromia,Bale,Delo Mena,94,45,20,159
Miyazia,8th,2011,Oromia,West Wellega,Mene Sibu,10,59,13,82
Ginbot,9th,2009,Oromia,Jimma,Sekoru,69,86,33,188
Sene,10th,2010,Oromia,Arsi,Enkelo Wabe,57,34,52,143
Ginbot,9th,2011,Oromia,Buno Bedele,Chora,65,74,50,189
Teqemt,2nd,2010,Oromia,Ilu Aba Bora,Doreni,18,79,93,190
Tir,5th,2011,Oromia,East Shewa,Boset,78,0,62,140
Ginbot,9th,2010,Oromia,Horo Gudru Wellega,Horro Buluk,66,3,70,139
Tahesas,4th,2010,Oromia,West Guji,Gelana,98,3,47,148
Meskerem,1st,2010,Oromia,East Shewa,Adea,42,90,95,227
Yekatit,6th,2010,Oromia,Borena,Dire,82,51,83,216
Miyazia,8th,2010,Oromia,West Guji,Mkelka Soda,84,54,56,194
Megabit,7th,2009,Oromia,Guji,Shakiso Town,34,51,21,106
Tir,5th,2009,Oromia,West Hararge,Meiso,73,92,40,205
Megabit,7th,2010,Oromia,West Shewa,Chelia,67,58,72,197
Yekatit,6th,2011,Oromia,West Shewa,Adea Berga,80,32,41,153
Tir,5th,2009,Oromia,Jimma,Seka Chekorsa,80,1,70,151
Megabit,7th,2010,Oromia,Modjo Town,Modjo Town,18,63,30,111
Nehase,12th,2009,Oromia,West Wellega,Babo Gembel,46,67,59,172
Megabit,7th,2009,Oromia,West Wellega,Homa,48,52,25,125
Miyazia,8th,2011,Oromia,South West Shewa,Ameya,11,93,34,138
Yekatit,6th,2009,Oromia,East Shewa,Lomme,97,61,86,244
Tir,5th,2011,Oromia,Borena,Yabelo,91,41,62,194
Hamle,11th,2010,Oromia,Guji,Bore,45,90,34,169
Meskerem,1st,2010,Oromia,North Shewa,Hidabu Abote,29,33,35,97
Hedar,3rd,2010,Oromia,East Hararge,Fedis,31,17,36,84
Meskerem,1st,2011,Oromia,West Shewa,Jeldu,75,35,59,169
Ginbot,9th,2011,Oromia,North Shewa,Hidabu Abote,43,97,81,221
Megabit,7th,2010,Oromia,Ilu Aba Bora,Darimu,47,66,39,152
Tahesas,4th,2011,Oromia,West Shewa,Nono,78,18,95,191
Miyazia,8th,2010,Oromia,East Hararge,Haromaya Rural,35,27,2,64
Yekatit,6th,2010,Oromia,Assela Town,Assela Town,66,29,12,107
Megabit,7th,2011,Oromia,North Shewa,Yaya Gulele,32,31,86,149
Meskerem,1st,2011,Oromia,East Hararge,Haromaya Hospital,64,39,59,162
Megabit,7th,2010,Oromia,Bale,Dawe Qachen,85,66,2,153
Sene,10th,2011,Oromia,East Hararge,Jarso,73,83,37,193
Yekatit,6th,2009,Oromia,North Shewa,Yaya Gulele,98,82,46,226
Miyazia,8th,2010,Oromia,West Wellega,Gimbi,78,51,69,198
Yekatit,6th,2011,Oromia,East Shewa,Gimbichu,99,64,84,247
Miyazia,8th,2011,Oromia,Buno Bedele,Bedele Hospital,13,6,67,86
Hamle,11th,2009,Oromia,Jimma,Kersa,82,85,70,237
Sene,10th,2009,Oromia,East Wellega,Sasiga,71,54,5,130
Megabit,7th,2011,Oromia,Bale,Seweyna,53,35,57,145
Tahesas,4th,2011,Oromia,Jimma,Omonada,61,33,98,192
Tir,5th,2010,Oromia,South West Shewa,Dawo,41,80,97,218
Tir,5th,2011,Oromia,West Wellega,Homa,74,45,13,132
Teqemt,2nd,2010,Oromia,Borena,Moyale Hospital,69,15,14,98
Yekatit,6th,2009,Oromia,West Shewa,Elifata,69,7,15,91
Hamle,11th,2009,Oromia,Bale,Gololcha,49,66,44,159
Hamle,11th,2010,Oromia,South West Shewa,Bantu  Hospital,74,98,53,225
Megabit,7th,2009,Oromia,West Guji,Mkelka Soda,85,69,34,188
Tahesas,4th,2010,Oromia,East Hararge,Aweday Town,67,16,42,125
Meskerem,1st,2010,Oromia,Jimma,Mancho,53,19,69,141
Hamle,11th,2009,Oromia,East Shewa,Matahara,3,43,15,61
Yekatit,6th,2009,Oromia,Finfine Zuria,Holeta,84,4,37,125
Tahesas,4th,2010,Oromia,West Arsi,Arsi Negele Town,75,3,87,165
Teqemt,2nd,2011,Oromia,East Shewa,Boset,68,34,27,129
Megabit,7th,2009,Oromia,West Guji,Bule Hora,8,2,69,79
Miyazia,8th,2009,Oromia,South West Shewa,Becho,16,27,51,94
Hedar,3rd,2011,Oromia,West Guji,Suro Barguda,21,10,4,35
Tahesas,4th,2011,Oromia,West Shewa,Jeldu,48,10,21,79
Megabit,7th,2010,Oromia,West Shewa,Ilu Galan,94,18,6,118
Meskerem,1st,2011,Oromia,Guji,Gumi Eldallo,41,23,56,120
Yekatit,6th,2010,Oromia,Qeleme Wellega,Sedan Chanka,3,83,10,96
Ginbot,9th,2011,Oromia,West Wellega,Lata Sibu,30,75,12,117
Ginbot,9th,2010,Oromia,West Wellega,Begi,27,75,78,180
Tahesas,4th,2010,Oromia,East Hararge,Kurfa Chele,80,42,12,134
Tahesas,4th,2011,Oromia,Arsi,Ludehetosa,88,97,36,221
Megabit,7th,2010,Oromia,Robe Town,Robe Town,47,85,87,219
Megabit,7th,2010,Oromia,Arsi,Shirka,74,93,84,251
Megabit,7th,2010,Oromia,Jimma,B/Tolyi,56,93,5,154
Tahesas,4th,2011,Oromia,West Shewa,Jeldu,20,0,23,43
Tir,5th,2011,Oromia,Bale,Goba,92,77,46,215
Meskerem,1st,2011,Oromia,Borena,Arero,78,76,55,209
Tahesas,4th,2011,Oromia,Arsi,Shirka,53,29,38,120
Meskerem,1st,2010,Oromia,Bishoftu Town,Bishoftu Town,46,64,76,186
Teqemt,2nd,2010,Oromia,West Hararge,Gelemso Hospital,38,33,45,116
Ginbot,9th,2011,Oromia,West Arsi,Shashemene Rural,99,12,84,195
Sene,10th,2009,Oromia,Arsi,Sude,94,24,60,178
Hamle,11th,2009,Oromia,Jimma,Mancho,59,65,6,130
Tir,5th,2009,Oromia,West Guji,Gelana,52,48,29,129
Megabit,7th,2010,Oromia,Bale,Gololcha,12,25,12,49
Hamle,11th,2009,Oromia,West Arsi,Dodola Town,59,27,62,148
Miyazia,8th,2011,Oromia,South West Shewa,Ameya,54,61,93,208
Teqemt,2nd,2011,Oromia,Jimma,Nono Benja,66,51,35,152
Meskerem,1st,2011,Oromia,West Wellega,Nejo Rural,56,97,51,204
Miyazia,8th,2009,Oromia,West Hararge,Gelemso Hospital,8,5,26,39
Meskerem,1st,2011,Oromia,East Shewa,Boset,7,58,11,76
Hamle,11th,2010,Oromia,Ilu Aba Bora,Algesachi,57,56,31,144
Megabit,7th,2011,Oromia,North Shewa,Wuchale,69,48,50,167
Tir,5th,2009,Oromia,East Hararge,Jarso,53,34,59,146
Megabit,7th,2010,Oromia,South West Shewa,St.Luke Hospital,75,6,24,105
Megabit,7th,2010,Oromia,Shashamane Town,Shashamane Town,74,50,52,176
Sene,10th,2009,Oromia,Buno Bedele,Boricha,70,44,96,210
Tir,5th,2011,Oromia,Bale,Goro,83,10,91,184
Tir,5th,2011,Oromia,Qeleme Wellega,Gidami,88,41,49,178
Miyazia,8th,2010,Oromia,West Hararge,West Harerge	Gumbi Bordede,55,43,52,150
Miyazia,8th,2009,Oromia,Ilu Aba Bora,Yayu,68,10,84,162
Sene,10th,2010,Oromia,Horo Gudru Wellega,Jima Geneti,26,80,44,150
Meskerem,1st,2011,Oromia,West Shewa,Bako Tibe,35,27,35,97
Miyazia,8th,2010,Oromia,East Wellega,Jimma Arjo,68,26,74,168
Tir,5th,2009,Oromia,West Guji,Hanbala,71,75,16,162
Miyazia,8th,2009,Oromia,North Shewa,Abichugna,89,29,90,208
Hamle,11th,2009,Oromia,Sululta Town,Sululta Town,76,37,48,161
Tir,5th,2011,Oromia,West Shewa,Bako Tibe,6,40,32,78
Miyazia,8th,2010,Oromia,West Hararge,Habro,43,91,42,176
Sene,10th,2010,Oromia,East Hararge,Kombolicha,90,90,59,239
Tir,5th,2009,Oromia,Borena,Teltele,93,53,77,223
Yekatit,6th,2009,Oromia,West Hararge,Habro,41,21,48,110
Hedar,3rd,2010,Oromia,East Hararge,Jarso,12,38,27,77
Yekatit,6th,2009,Oromia,Jimma,Sigmo,99,64,85,248
Meskerem,1st,2010,Oromia,Bale,Gololcha,38,49,85,172
Tahesas,4th,2011,Oromia,West Hararge,Gelemso Hospital,64,14,59,137
Sene,10th,2010,Oromia,West Wellega,Ayira,14,78,51,143
Nehase,12th,2010,Oromia,Arsi,Merti,26,20,84,130
Meskerem,1st,2011,Oromia,East Hararge,Kumbi,3,32,40,75
Tir,5th,2011,Oromia,Guji,Liben,39,29,20,88
Miyazia,8th,2010,Oromia,Horo Gudru Wellega,Jima Geneti,45,71,52,168
Sene,10th,2010,Oromia,East Hararge,Midega Tole,90,89,28,207
Hamle,11th,2009,Oromia,Jimma,B/Tolyi,47,12,34,93
Miyazia,8th,2011,Oromia,Arsi,Sude,5,2,14,21
Tir,5th,2010,Oromia,North Shewa,Aleiltu,68,14,77,159
Tir,5th,2009,Oromia,Ilu Aba Bora,Didu,97,54,88,239
Hamle,11th,2009,Oromia,Jimma,Kersa,1,18,93,112
Miyazia,8th,2011,Oromia,Qeleme Wellega,Gidami Hosp,87,50,85,222
Tir,5th,2009,Oromia,East Shewa,Adami Tulu Jido Kombolcha,83,21,23,127
Ginbot,9th,2011,Oromia,Guji,Uraga,66,82,85,233
Teqemt,2nd,2011,Oromia,Jimma,Setema,53,84,45,182
Hamle,11th,2010,Oromia,West Wellega,Seyo Nole,10,29,79,118
Hedar,3rd,2010,Oromia,Buno Bedele,Dapho Hana,44,39,39,122
Nehase,12th,2010,Oromia,Burayu Town,Burayu Town,45,49,80,174
Hamle,11th,2009,Oromia,Finfine Zuria,Berreh,64,12,37,113
Tahesas,4th,2010,Oromia,West Guji,Mkelka Soda,32,25,53,110
Meskerem,1st,2010,Oromia,West Arsi,Wondo,15,62,50,127
Megabit,7th,2010,Oromia,West Guji,Bule Hora,86,2,64,152
Hamle,11th,2009,Oromia,Ilu Aba Bora,Algesachi,86,54,48,188
Tahesas,4th,2010,Oromia,Buno Bedele,Diga,89,86,34,209
Tahesas,4th,2010,Oromia,Qeleme Wellega,Jimma Horo,39,36,68,143
Miyazia,8th,2009,Oromia,West Arsi,Kore,52,4,18,74
Ginbot,9th,2009,Oromia,West Shewa,Dano,78,77,85,240
Miyazia,8th,2010,Oromia,Jimma,B/Tolyi,32,30,99,161
Miyazia,8th,2010,Oromia,Guji,Wadara,20,11,46,77
Nehase,12th,2009,Oromia,Arsi,Zeway Dugda,97,61,84,242
Megabit,7th,2010,Oromia,North Shewa,Kuyu,74,20,78,172
Miyazia,8th,2010,Oromia,East Wellega,Wayu Tuqa,8,89,8,105
Nehase,12th,2009,Oromia,West Wellega,Boji Dermeji,45,7,9,61
Tahesas,4th,2011,Oromia,West Arsi,Arsi Negele Rural,52,76,53,181
Ginbot,9th,2009,Oromia,North Shewa,Degem,58,16,53,127
Yekatit,6th,2009,Oromia,East Hararge,Bisidimo Hospital,0,52,85,137
Sene,10th,2009,Oromia,West Guji,Kercha Hospital,65,52,22,139
Tir,5th,2010,Oromia,East Wellega,Boneya Bushe,50,74,96,220
Ginbot,9th,2009,Oromia,Borena,Dubluk,22,78,23,123
Ginbot,9th,2010,Oromia,West Wellega,Babo Gembel,13,85,49,147
Nehase,12th,2009,Oromia,East Wellega,Diga,49,70,98,217
Teqemt,2nd,2011,Oromia,East Hararge,Deder,39,18,78,135
Tir,5th,2009,Oromia,West Shewa,Gedo Hospital,99,82,46,227
Ginbot,9th,2010,Oromia,West Hararge,Doba,68,27,42,137
Hamle,11th,2009,Oromia,Bale,Ginir Town,10,80,56,146
Ginbot,9th,2011,Oromia,Borena,Dhas,86,33,3,122
Miyazia,8th,2009,Oromia,West Wellega,Yubdo,16,55,48,119
Tir,5th,2010,Oromia,East Wellega,Gida Ayana,32,88,76,196
Hedar,3rd,2011,Oromia,Shashamane Town,Shashamane Town,46,78,96,220
Tahesas,4th,2011,Oromia,West Arsi,Gedeb Asasa,43,35,85,163
Nehase,12th,2009,Oromia,Sululta Town,Sululta Town,42,57,84,183
Megabit,7th,2010,Oromia,East Hararge,Babile,24,90,72,186
Tir,5th,2011,Oromia,East Shewa,Matahara,34,4,76,114
Tahesas,4th,2010,Oromia,North Shewa,Hidabu Abote,54,48,89,191
Tahesas,4th,2011,Oromia,North Shewa,Kuyu,91,54,62,207
Tir,5th,2009,Oromia,Buno Bedele,Meko,29,26,38,93
Nehase,12th,2009,Oromia,East Hararge,Goro Gutu,47,87,50,184
Tir,5th,2009,Oromia,South West Shewa,Goro,9,50,58,117
Miyazia,8th,2011,Oromia,Arsi,Guna,34,70,48,152
Hedar,3rd,2011,Oromia,West Hararge,Gelemso Hospital,52,89,46,187
Tir,5th,2010,Oromia,Guji,Negele Hospital,20,59,31,110
Hamle,11th,2010,Oromia,Guji,Anna Sora,82,50,42,174
Hedar,3rd,2011,Oromia,Jimma,Mana,67,33,59,159
Yekatit,6th,2011,Oromia,West Hararge,Chiro Town,16,74,76,166
Yekatit,6th,2010,Oromia,Jimma,Mana,41,25,50,116
Miyazia,8th,2010,Oromia,West Arsi,Arsi Negele Town,15,50,24,89
Hedar,3rd,2011,Oromia,Borena,Yabelo,8,3,43,54
Yekatit,6th,2011,Oromia,West Wellega,Ayira Hospital,32,54,72,158
Tahesas,4th,2010,Oromia,Buno Bedele,Chora,86,77,29,192
Sene,10th,2009,Oromia,Bale,Gasera,65,37,10,112
Teqemt,2nd,2011,Oromia,Ilu Aba Bora,Nono Sele,65,49,92,206
Hamle,11th,2010,Oromia,West Hararge,Anchar,99,50,6,155
Miyazia,8th,2010,Oromia,Buno Bedele,Dedesa,71,38,76,185
Meskerem,1st,2011,Oromia,Jimma,Omonada,42,48,18,108
Megabit,7th,2009,Oromia,Jimma,B/Tolyi,31,39,37,107
Yekatit,6th,2009,Oromia,Jimma,Sekoru,37,46,23,106
Teqemt,2nd,2011,Oromia,West Shewa,Jeldu,43,70,96,209
Ginbot,9th,2011,Oromia,West Shewa,Guder Hosp,71,3,26,100
Sene,10th,2009,Oromia,Guji,Adola Hospital,23,34,7,64
Tir,5th,2011,Oromia,Borena,Arero,69,44,73,186
Sene,10th,2009,Oromia,Jimma,Limu Kosa,13,84,79,176
Hedar,3rd,2011,Oromia,Bishoftu Town,Bishoftu Town,58,65,98,221
Tir,5th,2011,Oromia,Buno Bedele,Gechi,1,54,61,116
Tahesas,4th,2010,Oromia,West Shewa,Chelia,47,44,31,122
Yekatit,6th,2009,Oromia,Guji,Hambela Wamena,75,58,48,181
Ginbot,9th,2011,Oromia,West Wellega,Seyo Nole,29,80,34,143
Nehase,12th,2010,Oromia,East Hararge,Meyu Muleke,1,95,0,96
Hamle,11th,2009,Oromia,Arsi,Gololcha,71,47,53,171
Sene,10th,2011,Oromia,Horo Gudru Wellega,Jarte Jardga,42,75,99,216
Ginbot,9th,2010,Oromia,South West Shewa,Wonchi,79,84,9,172
Meskerem,1st,2011,Oromia,Horo Gudru Wellega,Horro Buluk,99,75,71,245
Tahesas,4th,2010,Oromia,West Hararge,Mesela,90,48,2,140
Megabit,7th,2010,Oromia,East Wellega,Sasiga,67,4,40,111
Hamle,11th,2010,Oromia,Adama Special Town,Adama Town,67,42,46,155
Tahesas,4th,2011,Oromia,Borena,Moyale,27,16,82,125
Miyazia,8th,2010,Oromia,Jimma,Mana,2,34,46,82
Nehase,12th,2010,Oromia,Ilu Aba Bora,Doreni,30,50,76,156
Megabit,7th,2011,Oromia,East Hararge,Deder Hospital,55,73,55,183
Ginbot,9th,2011,Oromia,Arsi,Enkelo Wabe,50,54,16,120
Megabit,7th,2009,Oromia,West Shewa,Jeldu,40,26,45,111
Megabit,7th,2010,Oromia,West Arsi,Siraro,95,11,90,196
Hamle,11th,2009,Oromia,Ilu Aba Bora,Halu,90,7,17,114
Miyazia,8th,2010,Oromia,West Shewa,Dano,58,80,27,165
Ginbot,9th,2010,Oromia,West Wellega,Genji,34,19,4,57
Nehase,12th,2009,Oromia,Jimma,Sekoru,36,29,93,158
Tir,5th,2010,Oromia,West Hararge,West Harerge	Gumbi Bordede,7,22,74,103
Miyazia,8th,2009,Oromia,West Hararge,Burka Dimtu,44,98,8,150
Meskerem,1st,2011,Oromia,West Shewa,Jeldu,30,22,89,141
Tir,5th,2011,Oromia,East Hararge,Haromaya Hospital,81,69,29,179
Yekatit,6th,2010,Oromia,West Arsi,Gedeb Asasa,93,66,43,202
Hamle,11th,2010,Oromia,West Hararge,Doba,7,47,54,108
Ginbot,9th,2010,Oromia,Horo Gudru Wellega,Horo,22,61,22,105
Tahesas,4th,2010,Oromia,East Shewa,Fentale,31,6,74,111
Sene,10th,2011,Oromia,Arsi,Deksis,65,24,88,177
Yekatit,6th,2009,Oromia,Guji,Adola Reda,85,89,9,183
Hamle,11th,2009,Oromia,West Guji,Bule Hora,61,31,46,138
Meskerem,1st,2010,Oromia,West Wellega,Qiltu Kara,56,41,49,146
Nehase,12th,2010,Oromia,Ilu Aba Bora,Hurumu,54,52,57,163
Sene,10th,2010,Oromia,Ilu Aba Bora,Yayu,35,94,27,156
Meskerem,1st,2010,Oromia,Borena,Moyale Hospital,34,75,91,200
Hamle,11th,2010,Oromia,Arsi,Jeju,54,18,91,163
Tahesas,4th,2011,Oromia,West Shewa,Inchini Hospital,43,7,36,86
Hedar,3rd,2010,Oromia,East Wellega,Haro Limu,58,31,10,99
Yekatit,6th,2010,Oromia,Arsi,Tena,40,7,34,81
Meskerem,1st,2010,Oromia,East Shewa,Boset,26,78,17,121
Ginbot,9th,2009,Oromia,West Guji,Dugda Dawa,38,9,29,76
Hedar,3rd,2011,Oromia,West Shewa,Midakegni,71,84,52,207
Ginbot,9th,2010,Oromia,West Arsi,Adaba,92,13,72,177
Sene,10th,2010,Oromia,West Arsi,Nensebo,62,12,99,173
Sene,10th,2009,Oromia,West Shewa,Metarobi,80,81,56,217
Sene,10th,2010,Oromia,Qeleme Wellega,Sedan Chanka,15,78,95,188
Nehase,12th,2009,Oromia,North Shewa,Aleiltu,21,95,49,165
Tir,5th,2010,Oromia,East Hararge,Bisidimo Hospital,27,60,24,111
Sene,10th,2010,Oromia,Jimma Spe Town,Jimma Spe Town,62,75,36,173
Meskerem,1st,2010,Oromia,Guji,Negele Hospital,20,71,15,106
Ginbot,9th,2011,Oromia,Adama Special Town,Adama Town,97,88,47,232
Nehase,12th,2010,Oromia,East Wellega,Haro Limu,48,90,0,138
Hedar,3rd,2010,Oromia,West Arsi,Kofele,29,63,24,116
Hedar,3rd,2011,Oromia,South West Shewa,Tulu Bolo Hospital,95,70,5,170
Meskerem,1st,2011,Oromia,West Shewa,Inchini Hospital,12,67,74,153
Miyazia,8th,2011,Oromia,West Shewa,Guder Hosp,43,89,71,203
Miyazia,8th,2010,Oromia,North Shewa,Girar Jarso,5,39,87,131
Hedar,3rd,2010,Oromia,Arsi,Sire,64,21,55,140
Sene,10th,2009,Oromia,Arsi,Tena,30,27,90,147
Ginbot,9th,2011,Oromia,Buno Bedele,Bedele Zuriya,89,78,92,259
Tahesas,4th,2011,Oromia,West Wellega,Nejo Town,55,45,60,160
Teqemt,2nd,2010,Oromia,Bale,Arena Buluq,47,65,74,186
Ginbot,9th,2009,Oromia,South West Shewa,Ameya,73,92,36,201
Tahesas,4th,2011,Oromia,West Wellega,Guliso,5,59,83,147
Hamle,11th,2010,Oromia,Borena,Meyo,31,8,15,54
Sene,10th,2011,Oromia,Qeleme Wellega,Hawa Gelan,96,54,85,235
Teqemt,2nd,2011,Oromia,Jimma,Sigmo,16,70,98,184
Teqemt,2nd,2011,Oromia,Arsi,Tiyo,64,83,30,177
Megabit,7th,2011,Oromia,Lege Dadi Lege Tafo Town,Lege Dadi Lege Tafo Town,64,39,53,156
Yekatit,6th,2010,Oromia,South West Shewa,Ilu,67,97,23,187
Hamle,11th,2009,Oromia,Ilu Aba Bora,Nono Sele,83,1,59,143
Tahesas,4th,2010,Oromia,Jimma,Omonada,21,11,94,126
Meskerem,1st,2011,Oromia,East Shewa,Adea,33,90,2,125
Ginbot,9th,2010,Oromia,Borena,Moyale Hospital,97,46,52,195
Miyazia,8th,2010,Oromia,West Shewa,Elifata,13,4,48,65
Tahesas,4th,2011,Oromia,Jimma,Kersa,94,98,27,219
Sene,10th,2009,Oromia,West Wellega,Ayira Hospital,78,74,5,157
Yekatit,6th,2010,Oromia,West Wellega,Nejo Hospital,18,98,35,151
Nehase,12th,2009,Oromia,East Wellega,Kiremu,97,37,66,200
Megabit,7th,2011,Oromia,West Shewa,Metarobi,32,23,92,147
Tahesas,4th,2010,Oromia,West Wellega,Begi Hospital,70,76,56,202
Yekatit,6th,2010,Oromia,Guji,Goro Dola,93,40,12,145
Hedar,3rd,2010,Oromia,East Wellega,Nunu Qumba,98,18,54,170
Sene,10th,2009,Oromia,Jimma,Sigmo,5,9,0,14
Nehase,12th,2009,Oromia,East Hararge,Goro Gutu,18,72,74,164
Ginbot,9th,2010,Oromia,South West Shewa,Ameya,24,16,82,122
Nehase,12th,2009,Oromia,Guji,Gumi Eldallo,99,99,2,200
Hamle,11th,2010,Oromia,West Wellega,Genji,64,49,58,171
Tahesas,4th,2011,Oromia,Bale,Dinsho,70,18,35,123
Teqemt,2nd,2011,Oromia,Ilu Aba Bora,Darimu,49,52,2,103
Meskerem,1st,2010,Oromia,East Hararge,Kombolicha,0,54,30,84
Tir,5th,2009,Oromia,Jimma,Dedo,4,59,59,122
Hedar,3rd,2010,Oromia,Bale,Sinana,24,18,36,78
Tir,5th,2009,Oromia,West Shewa,Bako Tibe,28,47,14,89
Ginbot,9th,2009,Oromia,East Hararge,Deder,35,3,84,122
Meskerem,1st,2011,Oromia,Arsi,Sude,3,16,28,47
Yekatit,6th,2011,Oromia,Arsi,Tiyo,42,43,28,113
Nehase,12th,2009,Oromia,Finfine Zuria,Sululta Town,80,75,84,239
Ginbot,9th,2010,Oromia,North Shewa,Abichugna,23,15,3,41
Ginbot,9th,2010,Oromia,Guji,Anna Sora,34,39,3,76
Meskerem,1st,2011,Oromia,West Arsi,Dodola  Hospital,43,9,33,85
Sene,10th,2011,Oromia,Ilu Aba Bora,Bure,83,51,97,231
Hedar,3rd,2010,Oromia,East Wellega,Wayu Tuqa,69,72,91,232
Hamle,11th,2010,Oromia,West Shewa,Ejersa Lafo,57,78,34,169
Ginbot,9th,2010,Oromia,Qeleme Wellega,Dale Wabera,54,80,98,232
Megabit,7th,2009,Oromia,Qeleme Wellega,Seyo,2,16,85,103
Ginbot,9th,2011,Oromia,West Guji,Mkelka Soda,31,93,91,215
Yekatit,6th,2009,Oromia,Borena,Dhas,1,95,83,179
Teqemt,2nd,2011,Oromia,Arsi,Limuna Bilbilo,21,73,90,184
Megabit,7th,2009,Oromia,East Hararge,Fedis,50,52,11,113
Ginbot,9th,2011,Oromia,West Shewa,Dano,95,0,74,169
Sene,10th,2010,Oromia,North Shewa,Kuyu Hospital,15,96,10,121
Sene,10th,2011,Oromia,Jimma,Shabe,0,6,9,15
Yekatit,6th,2009,Oromia,West Wellega,Begi,44,39,31,114
Sene,10th,2010,Oromia,West Guji,Dugda Dawa,34,58,73,165
Megabit,7th,2009,Oromia,Horo Gudru Wellega,Jarte Jardga,82,74,67,223
Miyazia,8th,2011,Oromia,Ilu Aba Bora,Darimu,91,27,77,195
Meskerem,1st,2010,Oromia,Borena,Yabelo,52,0,85,137
Sene,10th,2009,Oromia,West Shewa,Ginde Beret,21,63,75,159
Meskerem,1st,2011,Oromia,Guji,Adola Reda,64,54,11,129
Megabit,7th,2009,Oromia,East Hararge,Garemuleta Hospital,82,94,73,249
Meskerem,1st,2011,Oromia,West Arsi,Adaba,43,78,88,209
Hamle,11th,2010,Oromia,East Hararge,Melka Belo,79,3,59,141
Meskerem,1st,2010,Oromia,Guji,Aga Wayyu,63,60,3,126
Tir,5th,2010,Oromia,East Hararge,Kumbi,89,45,41,175
Hedar,3rd,2010,Oromia,West Arsi,Gedeb Asasa,94,77,59,230
Teqemt,2nd,2011,Oromia,East Hararge,Goro Muti,44,36,5,85
Megabit,7th,2010,Oromia,Jimma,Guma,43,73,71,187
Yekatit,6th,2009,Oromia,East Wellega,Guto Gida,80,67,9,156
Hamle,11th,2010,Oromia,Ilu Aba Bora,Bure,28,17,36,81
Hedar,3rd,2011,Oromia,Bale,Gololcha,74,68,28,170
Teqemt,2nd,2010,Oromia,West Shewa,Tibe Kutaye,62,31,38,131
Megabit,7th,2010,Oromia,West Arsi,Dodola Town,51,85,57,193
Miyazia,8th,2011,Oromia,Finfine Zuria,Sandefa,1,83,79,163
Megabit,7th,2010,Oromia,East Hararge,Kombolicha,54,92,56,202
Tahesas,4th,2011,Oromia,Borena,Dhas,12,82,88,182
Nehase,12th,2010,Oromia,Horo Gudru Wellega,Abe Dengoro,37,3,95,135
Tir,5th,2009,Oromia,Horo Gudru Wellega,Jima Rare,77,73,87,237
Sene,10th,2010,Oromia,West Wellega,Homa,81,23,65,169
Yekatit,6th,2011,Oromia,Finfine Zuria,Akaki,34,40,40,114
Megabit,7th,2009,Oromia,West Shewa,Midakegni,71,57,75,203
Ginbot,9th,2011,Oromia,Qeleme Wellega,Gidami Hosp,89,86,62,237
Megabit,7th,2010,Oromia,Guji,Goro Dola,5,69,22,96
Hedar,3rd,2011,Oromia,South West Shewa,Bantu  Hospital,48,32,1,81
Ginbot,9th,2009,Oromia,Guji,Liben,51,79,52,182
Teqemt,2nd,2011,Oromia,West Arsi,Shashemene Rural,96,36,27,159
Tir,5th,2010,Oromia,East Wellega,Diga,51,84,15,150
Megabit,7th,2011,Oromia,West Shewa,Midakegni,54,91,21,166
Teqemt,2nd,2011,Oromia,Arsi,Guna,30,93,64,187
Ginbot,9th,2009,Oromia,Bale,Goro,25,59,41,125
Hedar,3rd,2011,Oromia,West Wellega,Lata Sibu,18,13,79,110
Tir,5th,2010,Oromia,West Wellega,Nejo Rural,93,38,10,141
Sene,10th,2010,Oromia,Buno Bedele,Diga,34,59,28,121
Tahesas,4th,2010,Oromia,West Shewa,Ilu Galan,47,32,95,174
Nehase,12th,2010,Oromia,Borena,Yabelo Rural,26,21,30,77
Miyazia,8th,2009,Oromia,Buno Bedele,Dapho Hana,54,33,25,112
Meskerem,1st,2011,Oromia,Finfine Zuria,Akaki,73,99,95,267
Tir,5th,2011,Oromia,North Shewa,Degem,96,92,79,267
Ginbot,9th,2009,Oromia,South West Shewa,Tole,98,15,30,143
Tir,5th,2011,Oromia,Buno Bedele,Dapho Hana,6,97,5,108
Ginbot,9th,2011,Oromia,Guji,Dima,3,32,68,103
Nehase,12th,2010,Oromia,Buno Bedele,Dapho Hana,78,39,0,117
Miyazia,8th,2011,Oromia,Jimma,Limu Kosa,22,51,38,111
Sene,10th,2010,Oromia,West Wellega,Homa,6,12,97,115
Hamle,11th,2010,Oromia,East Wellega,Leqa Dulecha,78,56,64,198
Tir,5th,2011,Oromia,East Hararge,Kumbi,69,12,67,148
Hamle,11th,2009,Oromia,Qeleme Wellega,Jimma Horo,9,13,29,51
Hedar,3rd,2011,Oromia,West Shewa,Jeldu,85,38,22,145
Ginbot,9th,2011,Oromia,Guji,Dima,6,22,74,102
Sene,10th,2009,Oromia,East Shewa,Lomme,94,62,86,242
Megabit,7th,2010,Oromia,Bale,Berbere,98,5,44,147
Tir,5th,2010,Oromia,West Hararge,Oda Bultum,14,69,57,140
Sene,10th,2009,Oromia,Jimma Spe Town,Jimma Spe Town,19,77,15,111
Meskerem,1st,2010,Oromia,South West Shewa,Ameya,30,6,60,96
Sene,10th,2011,Oromia,Qeleme Wellega,Kake Hosp,82,55,95,232
Hedar,3rd,2011,Oromia,Ilu Aba Bora,Hurumu,77,99,95,271
Ginbot,9th,2011,Oromia,Finfine Zuria,Sululta Town,78,43,75,196
Yekatit,6th,2009,Oromia,West Hararge,Bedesa Town,48,12,72,132
Miyazia,8th,2011,Oromia,West Shewa,Adea Berga,85,43,14,142
Tir,5th,2009,Oromia,West Guji,Abaya,6,33,18,57
Ginbot,9th,2010,Oromia,Guji,Wadara,40,22,53,115
Hedar,3rd,2010,Oromia,East Wellega,Limu,57,41,74,172
Nehase,12th,2009,Oromia,Jimma,Tiro Afeta,39,29,95,163
Tir,5th,2011,Oromia,Buno Bedele,Dapho Hana,19,74,46,139
Yekatit,6th,2010,Oromia,East Hararge,Kersa Eh,26,57,16,99
Ginbot,9th,2010,Oromia,Arsi,Aseko,49,93,46,188
Hamle,11th,2010,Oromia,North Shewa,Wuchale,17,79,53,149
Teqemt,2nd,2011,Oromia,West Wellega,Nejo Hospital,73,98,97,268
Megabit,7th,2010,Oromia,East Hararge,Kumbi,96,10,33,139
Sene,10th,2010,Oromia,Finfine Zuria,Mullo,74,56,88,218
Tir,5th,2010,Oromia,Guji,Dima,26,82,57,165
Nehase,12th,2010,Oromia,West Shewa,Ejersa Lafo,96,75,27,198
Megabit,7th,2011,Oromia,Arsi,Ludehetosa,64,63,63,190
Nehase,12th,2010,Oromia,East Wellega,Sibu Sire,26,36,46,108
Ginbot,9th,2009,Oromia,East Wellega,Gobu Seyo,45,5,41,91
Sene,10th,2009,Oromia,East Hararge,Bedeno,83,97,79,259
Hamle,11th,2010,Oromia,West Hararge,Hawi Gudina,82,33,41,156
Yekatit,6th,2010,Oromia,East Hararge,Meta,32,50,26,108
Nehase,12th,2010,Oromia,Bale,Seweyna,45,40,96,181
Sene,10th,2011,Oromia,Guji,Adola Hospital,43,21,78,142
Miyazia,8th,2011,Oromia,Qeleme Wellega,Gidami,71,34,91,196
Megabit,7th,2010,Oromia,Woliso Town,Woliso Town,78,48,18,144
Ginbot,9th,2011,Oromia,West Hararge,Hawi Gudina,23,65,95,183
Hamle,11th,2010,Oromia,East Hararge,Midega Tole,3,93,8,104
Ginbot,9th,2010,Oromia,Jimma,Setema,52,14,21,87
Hamle,11th,2010,Oromia,Bale,Sinana,64,87,66,217
Megabit,7th,2009,Oromia,West Wellega,Mendi Hospital,59,2,15,76
Miyazia,8th,2011,Oromia,South West Shewa,Dawo,76,80,40,196
Nehase,12th,2010,Oromia,West Wellega,Nejo Rural,82,54,41,177
Nehase,12th,2009,Oromia,South West Shewa,Tulu Bolo Hospital,24,27,78,129
Sene,10th,2009,Oromia,Buno Bedele,Dedesa,52,68,29,149
Meskerem,1st,2011,Oromia,West Shewa,Elifata,92,67,60,219
Miyazia,8th,2009,Oromia,West Shewa,Meta Waliqite,14,84,68,166
Megabit,7th,2009,Oromia,Adama Special Town,Adama Town,47,75,10,132
Hedar,3rd,2011,Oromia,West Wellega,Nole Kaba,82,63,76,221
Ginbot,9th,2011,Oromia,Bale,Dinsho,31,40,42,113
Megabit,7th,2009,Oromia,Qeleme Wellega,Dambi Dolo Hospital,1,70,38,109
Hedar,3rd,2010,Oromia,North Shewa,Hidabu Abote,8,92,36,136
Hamle,11th,2009,Oromia,East Wellega,Sasiga,73,80,80,233
Ginbot,9th,2010,Oromia,Ilu Aba Bora,Doreni,82,77,11,170
Megabit,7th,2011,Oromia,West Shewa,Jeldu,24,45,14,83
Hedar,3rd,2011,Oromia,Assela Town,Assela Town,65,50,31,146
Hamle,11th,2010,Oromia,Bale,Gasera,11,91,28,130
Teqemt,2nd,2011,Oromia,West Shewa,Midakegni,9,17,34,60
Hedar,3rd,2011,Oromia,East Hararge,Babile Woreda,83,52,77,212
Tir,5th,2010,Oromia,West Arsi,Kokosa,51,69,5,125
Yekatit,6th,2011,Oromia,West Arsi,Kore,44,90,25,159
Sene,10th,2011,Oromia,Jimma,Mancho,53,57,75,185
Tir,5th,2010,Oromia,East Shewa,Adea,80,17,72,169
Teqemt,2nd,2010,Oromia,West Shewa,Chelia,82,65,29,176
Megabit,7th,2009,Oromia,Arsi,Ludehetosa,26,47,21,94
Ginbot,9th,2010,Oromia,East Shewa,Gimbichu,86,21,93,200
Ginbot,9th,2010,Oromia,Horo Gudru Wellega,Abe Dengoro,47,97,45,189
Tir,5th,2009,Oromia,West Guji,Gelana,22,97,49,168
Tir,5th,2011,Oromia,West Arsi,Dodola Town,56,43,66,165
Ginbot,9th,2010,Oromia,Horo Gudru Wellega,Abe Dengoro,52,87,5,144
Hamle,11th,2010,Oromia,Horo Gudru Wellega,Shambu Town,73,88,59,220
Yekatit,6th,2009,Oromia,Arsi,Guna,90,2,86,178
Tahesas,4th,2011,Oromia,East Wellega,Leqa Dulecha,16,70,6,92
Miyazia,8th,2009,Oromia,South West Shewa,Wonchi,39,45,39,123
Sene,10th,2009,Oromia,West Guji,Abaya,31,54,27,112
Meskerem,1st,2011,Oromia,Ilu Aba Bora,Halu,38,21,78,137
Hamle,11th,2009,Oromia,Guji,Dima,18,94,6,118
Nehase,12th,2009,Oromia,West Guji,Suro Barguda,86,74,65,225
Hedar,3rd,2011,Oromia,East Hararge,Chinakesen,19,50,21,90
Miyazia,8th,2009,Oromia,Jimma,Shabe,98,8,41,147
Teqemt,2nd,2011,Oromia,East Hararge,Gursum,89,21,38,148
Hamle,11th,2009,Oromia,Qeleme Wellega,Jimma Horo,97,4,62,163
Hamle,11th,2010,Oromia,Jimma,Dedo,51,61,32,144
Yekatit,6th,2011,Oromia,Arsi,Amigna,7,22,80,109
Yekatit,6th,2011,Oromia,Horo Gudru Wellega,Jarte Jardga,88,21,47,156
Meskerem,1st,2011,Oromia,West Hararge,West Harerge	Gumbi Bordede,42,93,46,181
Ginbot,9th,2010,Oromia,Arsi,Robe,51,37,90,178
Hedar,3rd,2011,Oromia,West Shewa,Ambo,46,74,5,125
Yekatit,6th,2011,Oromia,Guji,Aga Wayyu,42,72,17,131
Hamle,11th,2009,Oromia,Buno Bedele,Dapho Hana,23,90,64,177
Yekatit,6th,2009,Oromia,Guji,Gumi Eldallo,57,51,82,190
Tir,5th,2010,Oromia,West Hararge,Burka Dimtu,88,48,40,176
Nehase,12th,2009,Oromia,North Shewa,Fiche Hospital,34,51,77,162
Ginbot,9th,2009,Oromia,Bale,Legehida,81,38,15,134
Miyazia,8th,2009,Oromia,East Hararge,Chinakesen,67,80,81,228
Miyazia,8th,2009,Oromia,Arsi,Bekoji Town,96,63,70,229
Tir,5th,2009,Oromia,West Arsi,Kore,6,65,24,95
Ginbot,9th,2011,Oromia,East Wellega,Gida Ayana,65,36,89,190
Nehase,12th,2010,Oromia,East Hararge,Babile,41,38,66,145
Sene,10th,2011,Oromia,East Hararge,Kombolicha,7,33,93,133
Yekatit,6th,2010,Oromia,Arsi,Aseko,73,41,46,160
Hedar,3rd,2010,Oromia,Bale,Meda Welabu,87,35,68,190
Tir,5th,2011,Oromia,Jimma Spe Town,Jimma Spe Town,16,9,25,50
Sene,10th,2009,Oromia,West Wellega,Kundala,85,76,42,203
Nehase,12th,2009,Oromia,West Guji,Biebirsa Kojowa,39,8,79,126
Hedar,3rd,2011,Oromia,Arsi,Aseko,88,86,96,270
Tir,5th,2011,Oromia,South West Shewa,Tulu Bolo Hospital,88,43,25,156
Yekatit,6th,2011,Oromia,West Hararge,Burka Dimtu,5,65,73,143
Meskerem,1st,2010,Oromia,East Shewa,Adama,91,96,43,230
Sene,10th,2011,Oromia,West Arsi,Hebal Arsi,37,35,3,75
Yekatit,6th,2009,Oromia,East Wellega,Sibu Sire,75,63,87,225
Miyazia,8th,2009,Oromia,Ilu Aba Bora,Hurumu,65,94,3,162
Megabit,7th,2010,Oromia,Ilu Aba Bora,Algesachi,11,15,71,97
Ginbot,9th,2011,Oromia,Jimma,Setema,47,40,49,136
Ginbot,9th,2010,Oromia,South West Shewa,Kersana Malima,9,36,57,102
Sene,10th,2010,Oromia,Qeleme Wellega,Gawo Qebe,21,39,74,134
Yekatit,6th,2010,Oromia,Horo Gudru Wellega,Jarte Jardga,32,58,32,122
Miyazia,8th,2011,Oromia,Finfine Zuria,Mullo,17,99,65,181
Megabit,7th,2011,Oromia,West Guji,Bule Hora,31,86,86,203
Ginbot,9th,2009,Oromia,West Guji,Bule Hora,6,8,17,31
Ginbot,9th,2011,Oromia,North Shewa,Degem,11,24,21,56
Tir,5th,2011,Oromia,West Arsi,Adaba,51,67,96,214
Tir,5th,2009,Oromia,Jimma,Limu Hospital,87,70,43,200
Meskerem,1st,2011,Oromia,Jimma,Mana,11,32,35,78
Megabit,7th,2010,Oromia,Qeleme Wellega,Laloqile,98,52,69,219
Miyazia,8th,2011,Oromia,West Hararge,Tulo,53,38,83,174
Tir,5th,2010,Oromia,Horo Gudru Wellega,Hababo Guduru,98,12,13,123
Sene,10th,2009,Oromia,West Shewa,Codi,38,91,81,210
Teqemt,2nd,2010,Oromia,West Shewa,Ilu Galan,71,88,10,169
Tahesas,4th,2010,Oromia,West Wellega,Homa,95,61,95,251
Megabit,7th,2010,Oromia,Arsi,Gololcha,34,34,86,154
Sene,10th,2009,Oromia,Arsi,Sire,87,68,18,173
Meskerem,1st,2011,Oromia,West Wellega,Kundala,58,38,99,195
Sene,10th,2009,Oromia,Arsi,Digeluna Tijo,48,67,27,142
Hamle,11th,2009,Oromia,West Shewa,Guder Hosp,13,79,28,120
Sene,10th,2009,Oromia,East Hararge,Kumbi,1,68,77,146
Meskerem,1st,2010,Oromia,South West Shewa,Becho,5,9,27,41
Hedar,3rd,2010,Oromia,West Wellega,Seyo Nole,15,59,83,157
Yekatit,6th,2009,Oromia,West Hararge,Anchar,53,34,24,111
Ginbot,9th,2010,Oromia,West Arsi,Arsi Negele Rural,0,85,11,96
Meskerem,1st,2010,Oromia,West Shewa,Ambo Town,97,19,10,126
Hamle,11th,2010,Oromia,Lege Dadi Lege Tafo Town,Lege Dadi Lege Tafo Town,59,11,84,154
Sene,10th,2009,Oromia,Borena,Yabelo Hospital,10,61,88,159
Teqemt,2nd,2011,Oromia,North Shewa,Were Jarso,93,28,37,158
Yekatit,6th,2011,Oromia,Borena,Moyale,6,25,46,77
Miyazia,8th,2010,Oromia,West Wellega,Begi,2,76,12,90
Teqemt,2nd,2011,Oromia,Dukem Town,Dukem Town,93,58,64,215
Tir,5th,2009,Oromia,West Wellega,Kundala,74,59,29,162
Megabit,7th,2011,Oromia,West Hararge,Habro,96,71,62,229
Ginbot,9th,2010,Oromia,East Wellega,Sasiga,39,5,14,58
Yekatit,6th,2010,Oromia,West Arsi,Dodola Rural,95,67,67,229
Miyazia,8th,2009,Oromia,West Wellega,Gimbi Public  Hospital,0,28,59,87
Tir,5th,2010,Oromia,West Wellega,Lata Sibu,94,75,91,260
Megabit,7th,2010,Oromia,Qeleme Wellega,Dambi Dollo,91,32,81,204
Meskerem,1st,2010,Oromia,Bale,Sinana,60,15,42,117
Tir,5th,2011,Oromia,West Guji,Kercha,67,90,97,254
Hedar,3rd,2010,Oromia,West Wellega,Gimbi Public  Hospital,18,93,70,181
Yekatit,6th,2010,Oromia,Guji,Adola Hospital,88,92,91,271
Sene,10th,2010,Oromia,East Hararge,Haromaya Hospital,52,93,88,233
Nehase,12th,2009,Oromia,Arsi,Seru,59,95,97,251
Meskerem,1st,2011,Oromia,Jimma,Shabe,59,12,38,109
Yekatit,6th,2009,Oromia,North Shewa,Abichugna,36,43,87,166
Nehase,12th,2010,Oromia,South West Shewa,Ameya,74,36,5,115
Miyazia,8th,2010,Oromia,West Guji,Bule Hora Toun,84,23,22,129
Ginbot,9th,2010,Oromia,East Hararge,Kersa Eh,35,46,20,101
Miyazia,8th,2009,Oromia,West Hararge,Gemechis,18,17,46,81
Hedar,3rd,2011,Oromia,East Shewa,Bora,2,81,88,171
Nehase,12th,2009,Oromia,Horo Gudru Wellega,Abe Dengoro,88,90,97,275
Yekatit,6th,2010,Oromia,East Shewa,Lomme,1,88,27,116
Hedar,3rd,2011,Oromia,East Shewa,Boset,42,64,14,120
Sene,10th,2011,Oromia,Arsi,Seru,9,25,42,76
Yekatit,6th,2010,Oromia,Bale,Sinana,66,43,6,115
Hedar,3rd,2010,Oromia,East Wellega,Nunu Qumba,91,88,0,179
Miyazia,8th,2010,Oromia,Borena,Meyo,50,5,12,67
Nehase,12th,2010,Oromia,East Wellega,Nunu Qumba,31,43,24,98
Hedar,3rd,2010,Oromia,Arsi,Aseko,80,14,67,161
Hamle,11th,2009,Oromia,Qeleme Wellega,Dale Sedi,30,20,19,69
Sene,10th,2010,Oromia,West Wellega,Babo Gembel,15,43,76,134
Tir,5th,2011,Oromia,North Shewa,Debre Libanos,77,36,3,116
Teqemt,2nd,2010,Oromia,West Wellega,Lata Sibu,53,62,71,186
Yekatit,6th,2011,Oromia,Jimma,Omonada,76,19,54,149
Teqemt,2nd,2010,Oromia,Robe Town,Robe Town,60,46,39,145
Yekatit,6th,2009,Oromia,West Wellega,Boji Cheqorsa,50,59,79,188
Ginbot,9th,2010,Oromia,Guji,Negele Hospital,21,22,41,84
Nehase,12th,2010,Oromia,Jimma,Limu Hospital,79,47,26,152
Yekatit,6th,2009,Oromia,Qeleme Wellega,Dale Wabera,17,34,30,81
Hamle,11th,2010,Oromia,Guji,Girja,72,21,16,109
Ginbot,9th,2010,Oromia,North Shewa,Girar Jarso,27,78,71,176
Tir,5th,2010,Oromia,Bale,Arena Buluq,42,43,58,143
Ginbot,9th,2010,Oromia,West Wellega,Mene Sibu,7,75,45,127
Miyazia,8th,2010,Oromia,Arsi,Ludehetosa,32,66,79,177
Nehase,12th,2010,Oromia,Qeleme Wellega,Anfilo,53,63,50,166
Miyazia,8th,2010,Oromia,Bale,Gasera,60,48,30,138
Meskerem,1st,2010,Oromia,Finfine Zuria,Sebeta Awas,6,36,22,64
Ginbot,9th,2010,Oromia,Ilu Aba Bora,Ale,18,15,33,66
Meskerem,1st,2010,Oromia,Ilu Aba Bora,Didu,48,42,77,167
Tir,5th,2009,Oromia,Jimma,Limu Kosa,11,38,13,62
Tahesas,4th,2010,Oromia,Ilu Aba Bora,Metu Town,42,31,75,148
Ginbot,9th,2009,Oromia,Bale,Arena Buluq,83,60,70,213
Nehase,12th,2010,Oromia,Jimma,B/Tolyi,31,29,44,104
Megabit,7th,2010,Oromia,Borena,Dire,36,16,85,137
Sene,10th,2010,Oromia,East Hararge,Haromaya Rural,54,14,85,153
Tir,5th,2009,Oromia,Borena,Teltele,8,72,1,81
Megabit,7th,2009,Oromia,Borena,Dilo,94,0,83,177
Sene,10th,2010,Oromia,West Shewa,Ilu Galan,90,0,6,96
Tahesas,4th,2010,Oromia,West Wellega,Gimbi Public  Hospital,47,85,36,168
Miyazia,8th,2010,Oromia,West Guji,Bule Hora,28,38,24,90
Ginbot,9th,2009,Oromia,Finfine Zuria,Sebeta Awas,12,76,14,102
Meskerem,1st,2011,Oromia,East Wellega,Wama Hagelo,9,75,86,170
Teqemt,2nd,2010,Oromia,West Hararge,Guba Qoricha,7,65,44,116
Tir,5th,2010,Oromia,East Hararge,Fedis,20,3,52,75
Miyazia,8th,2011,Oromia,West Guji,Suro Barguda,77,51,3,131
Nehase,12th,2009,Oromia,North Shewa,Wuchale,98,83,77,258
Teqemt,2nd,2011,Oromia,Ilu Aba Bora,Algesachi,28,73,79,180
Hamle,11th,2010,Oromia,East Hararge,Babile,85,5,84,174
Tir,5th,2009,Oromia,Borena,Yabelo,32,78,79,189
Megabit,7th,2009,Oromia,West Hararge,Anchar,95,64,59,218
Yekatit,6th,2011,Oromia,Jimma,Mana,45,93,28,166
Hamle,11th,2010,Oromia,East Hararge,Chelenko Hospital,61,8,38,107
Tir,5th,2011,Oromia,West Guji,Bule Hora Hospital,3,73,82,158
Teqemt,2nd,2010,Oromia,South West Shewa,Sodo Dac'Ha,56,62,8,126
Megabit,7th,2010,Oromia,East Shewa,Dugda,36,90,89,215
Megabit,7th,2010,Oromia,East Shewa,Bora,99,27,45,171
Tir,5th,2011,Oromia,East Hararge,Midega Tole,6,51,46,103
Sene,10th,2010,Oromia,East Hararge,Melka Belo,56,17,15,88
Tahesas,4th,2010,Oromia,West Wellega,Homa,25,22,91,138
Meskerem,1st,2011,Oromia,East Hararge,Chinakesen,11,31,10,52
Sene,10th,2010,Oromia,West Wellega,Ayira,47,79,60,186
Megabit,7th,2010,Oromia,Burayu Town,Burayu Town,9,76,60,145
Teqemt,2nd,2011,Oromia,Guji,Adola Hospital,68,42,99,209
Megabit,7th,2009,Oromia,East Shewa,Olanciti Hospital,90,62,43,195
Meskerem,1st,2011,Oromia,East Shewa,Matahara,8,8,52,68
Ginbot,9th,2010,Oromia,Arsi,Tena,41,11,60,112
Hedar,3rd,2011,Oromia,West Wellega,Nejo Hospital,46,93,64,203
Megabit,7th,2011,Oromia,Arsi,Digeluna Tijo,41,7,79,127
Tahesas,4th,2011,Oromia,Ilu Aba Bora,Didu,61,60,2,123
Meskerem,1st,2011,Oromia,West Guji,Gelana,86,31,49,166
Tir,5th,2011,Oromia,Buno Bedele,Diga,5,27,61,93
Yekatit,6th,2010,Oromia,West Arsi,Dodola Town,26,1,86,113
Tir,5th,2011,Oromia,West Wellega,Boji Cheqorsa,96,86,0,182
Yekatit,6th,2010,Oromia,Arsi,Dodota,50,6,74,130
Megabit,7th,2010,Oromia,Guji,Gumi Eldallo,72,89,64,225
Teqemt,2nd,2010,Oromia,Jimma,Gomma,39,1,31,71
Hamle,11th,2009,Oromia,Jimma,Sekoru,23,43,96,162
Tir,5th,2011,Oromia,Guji,Bore,44,47,35,126
Tir,5th,2010,Oromia,Horo Gudru Wellega,Horo,10,73,18,101
Yekatit,6th,2011,Oromia,Arsi,Shirka,38,97,57,192
Sene,10th,2010,Oromia,Arsi,Seru,45,29,85,159
Yekatit,6th,2010,Oromia,East Wellega,Ebantu,81,19,25,125
Hamle,11th,2010,Oromia,West Shewa,Gojo Hospital,72,8,65,145
Nehase,12th,2010,Oromia,South West Shewa,Kersana Malima,62,74,96,232
Megabit,7th,2009,Oromia,West Shewa,Dano,87,49,90,226
Yekatit,6th,2009,Oromia,West Shewa,Gedo Hospital,98,93,23,214
Tahesas,4th,2010,Oromia,East Hararge,Haromaya Hospital,43,95,29,167
Ginbot,9th,2011,Oromia,Buno Bedele,Chewaqa,54,81,50,185
Meskerem,1st,2011,Oromia,Buno Bedele,Dapho Hana,54,84,24,162
Ginbot,9th,2009,Oromia,West Arsi,Gedeb Asasa,23,66,65,154
Meskerem,1st,2010,Oromia,Arsi,Gololcha,23,49,11,83
Tahesas,4th,2011,Oromia,Arsi,Munesa,53,56,71,180
Megabit,7th,2011,Oromia,Horo Gudru Wellega,Jima Geneti,46,52,32,130
Sene,10th,2011,Oromia,East Shewa,Fentale,28,70,20,118
Megabit,7th,2009,Oromia,Borena,Yabelo Hospital,51,85,26,162
Sene,10th,2011,Oromia,West Wellega,Haru,40,5,86,131
Miyazia,8th,2010,Oromia,West Shewa,Ejersa Lafo,65,7,72,144
Yekatit,6th,2009,Oromia,Qeleme Wellega,Hawa Gelan,24,47,22,93
Sene,10th,2010,Oromia,West Wellega,Homa,88,25,30,143
Teqemt,2nd,2011,Oromia,Guji,Hambela Wamena,10,75,13,98
Megabit,7th,2009,Oromia,Guji,Aga Wayyu,85,94,4,183
Hamle,11th,2010,Oromia,East Wellega,Guto Gida,78,63,43,184
Hamle,11th,2009,Oromia,Qeleme Wellega,Seyo,97,54,34,185
Hamle,11th,2009,Oromia,East Wellega,Nunu Qumba,0,28,75,103
Tahesas,4th,2010,Oromia,Guji,Odo Shakiso,27,86,44,157
Megabit,7th,2010,Oromia,Nekemte Town,Nekemte Town,75,65,28,168
Miyazia,8th,2011,Oromia,North Shewa,Kimbibit,24,16,61,101
Sene,10th,2009,Oromia,Borena,Dubluk,6,87,87,180
Tir,5th,2009,Oromia,East Hararge,Haromaya Hospital,6,57,90,153
Megabit,7th,2009,Oromia,Jimma Spe Town,Jimma Spe Town,8,75,14,97
Hedar,3rd,2011,Oromia,West Shewa,Metarobi,44,35,70,149
Tahesas,4th,2010,Oromia,Burayu Town,Burayu Town,16,76,92,184
Yekatit,6th,2010,Oromia,West Wellega,Jarso,69,59,72,200
Tir,5th,2011,Oromia,East Hararge,Kurfa Chele,26,2,49,77
Miyazia,8th,2009,Oromia,Qeleme Wellega,Dale Wabera,46,30,96,172
Tir,5th,2011,Oromia,South West Shewa,Bantu  Hospital,12,4,91,107
Ginbot,9th,2010,Oromia,Borena,Yabelo Hospital,23,63,65,151
Miyazia,8th,2009,Oromia,Buno Bedele,Chora,26,95,14,135
Hedar,3rd,2011,Oromia,Finfine Zuria,Akaki,73,9,39,121
Meskerem,1st,2011,Oromia,North Shewa,Jido,4,85,88,177
Tahesas,4th,2010,Oromia,Arsi,Jeju,78,35,8,121
Teqemt,2nd,2011,Oromia,Qeleme Wellega,Dale Sedi,57,31,81,169
Ginbot,9th,2010,Oromia,Borena,Moyale,98,14,34,146
Tahesas,4th,2010,Oromia,Arsi,Amigna,6,34,70,110
Yekatit,6th,2009,Oromia,West Wellega,Begi Hospital,71,76,0,147
Miyazia,8th,2010,Oromia,East Shewa,Liben,57,36,50,143
Yekatit,6th,2009,Oromia,Finfine Zuria,Sebeta Awas,15,95,50,160
Tahesas,4th,2010,Oromia,Buno Bedele,Bedele Town,53,47,22,122
Tir,5th,2011,Oromia,West Shewa,Jeldu,87,54,99,240
Tahesas,4th,2010,Oromia,Guji,Bore,72,72,96,240
Hedar,3rd,2011,Oromia,Borena,Yabelo Hospital,70,21,55,146
Megabit,7th,2010,Oromia,Borena,Dilo,4,77,89,170
Meskerem,1st,2010,Oromia,Qeleme Wellega,Hawa Gelan,0,84,57,141
Megabit,7th,2011,Oromia,East Wellega,Nunu Qumba,17,89,97,203
Tir,5th,2010,Oromia,West Guji,Bule Hora,12,85,12,109
Sene,10th,2009,Oromia,West Wellega,Guliso,50,30,81,161
Megabit,7th,2010,Oromia,West Hararge,Daro Lebu,61,5,5,71
Nehase,12th,2009,Oromia,West Wellega,Homa,77,47,93,217
Ginbot,9th,2010,Oromia,Qeleme Wellega,Gidami,29,77,92,198
Megabit,7th,2009,Oromia,West Shewa,Metarobi,13,65,10,88
Miyazia,8th,2009,Oromia,Ilu Aba Bora,Becho,41,23,57,121
Tir,5th,2009,Oromia,South West Shewa,Ameya,1,66,31,98
Tahesas,4th,2011,Oromia,Horo Gudru Wellega,Horo,99,66,49,214
Tir,5th,2011,Oromia,Qeleme Wellega,Jimma Horo,63,70,74,207
Tahesas,4th,2010,Oromia,West Wellega,Babo Gembel,96,66,40,202
Megabit,7th,2009,Oromia,East Wellega,Gobu Seyo,94,6,36,136
Tir,5th,2010,Oromia,Bale,Gololcha,77,93,79,249
Megabit,7th,2010,Oromia,Bale,Gololcha,47,96,1,144
Ginbot,9th,2009,Oromia,East Wellega,Wayu Tuqa,93,17,76,186
Tahesas,4th,2011,Oromia,Bale,Gasera,65,33,16,114
Ginbot,9th,2011,Oromia,West Hararge,Anchar,43,23,73,139
Yekatit,6th,2011,Oromia,Arsi,Tena,35,51,57,143
Ginbot,9th,2009,Oromia,Borena,Yabelo Rural,62,46,32,140
Hedar,3rd,2010,Oromia,Ilu Aba Bora,Metu Town,40,75,14,129
Tahesas,4th,2010,Oromia,West Wellega,Ayira,56,57,31,144
Miyazia,8th,2009,Oromia,West Hararge,Chiro Hospital,46,39,86,171
Meskerem,1st,2010,Oromia,Ilu Aba Bora,Yayu,83,51,86,220
Megabit,7th,2009,Oromia,East Shewa,Adama,36,69,80,185
Yekatit,6th,2011,Oromia,Guji,Hambela Wamena,90,94,42,226
Hedar,3rd,2011,Oromia,West Wellega,Yubdo,60,57,85,202
Hamle,11th,2009,Oromia,East Hararge,Kersa Eh,65,94,55,214
Miyazia,8th,2010,Oromia,South West Shewa,Wonchi,74,36,3,113
Miyazia,8th,2009,Oromia,East Hararge,Haromaya Town,43,47,20,110
Sene,10th,2010,Oromia,East Shewa,Lomme,19,99,38,156
Yekatit,6th,2011,Oromia,Lege Dadi Lege Tafo Town,Lege Dadi Lege Tafo Town,25,94,55,174
Ginbot,9th,2009,Oromia,East Hararge,Meta,90,98,19,207
Ginbot,9th,2011,Oromia,West Wellega,Mendi Hospital,54,67,76,197
Tahesas,4th,2010,Oromia,Buno Bedele,Dedesa,32,87,14,133
Tir,5th,2011,Oromia,Horo Gudru Wellega,Amuru,10,36,47,93
Miyazia,8th,2011,Oromia,Guji,Gumi Eldallo,89,74,42,205
Megabit,7th,2011,Oromia,West Shewa,Jibat,98,97,43,238
Sene,10th,2010,Oromia,Qeleme Wellega,Yemalogi Wolel,76,2,56,134
Teqemt,2nd,2011,Oromia,Adama Special Town,Adama Town,84,33,36,153
Nehase,12th,2010,Oromia,Qeleme Wellega,Laloqile,7,69,33,109
Yekatit,6th,2010,Oromia,Jimma,Mancho,70,4,31,105
Nehase,12th,2010,Oromia,West Wellega,Mendi Town,50,78,56,184
Miyazia,8th,2011,Oromia,Arsi,Deksis,58,49,5,112
Teqemt,2nd,2011,Oromia,West Shewa,Inchini Hospital,68,31,14,113
Meskerem,1st,2011,Oromia,Sebeta Town,Sebeta Town,2,87,19,108
Tir,5th,2011,Oromia,East Hararge,Bedeno,10,3,57,70
Hedar,3rd,2010,Oromia,West Shewa,Jeldu,75,42,0,117
Yekatit,6th,2010,Oromia,Guji,Gumi Eldallo,65,40,54,159
Hamle,11th,2010,Oromia,Qeleme Wellega,Seyo,16,96,42,154
Megabit,7th,2009,Oromia,Arsi,Munesa,22,98,23,143
Yekatit,6th,2010,Oromia,West Arsi,Shashemene Rural,59,91,29,179
Miyazia,8th,2011,Oromia,Borena,Dubluk,32,81,70,183
Nehase,12th,2010,Oromia,Horo Gudru Wellega,Jima Geneti,65,33,29,127
Teqemt,2nd,2011,Oromia,Guji,Bore,47,9,43,99
Megabit,7th,2009,Oromia,Qeleme Wellega,Dale Sedi,97,0,27,124
Sene,10th,2010,Oromia,Ilu Aba Bora,Hurumu,30,41,59,130
Yekatit,6th,2009,Oromia,East Wellega,Guto Gida,48,93,97,238
Miyazia,8th,2009,Oromia,East Hararge,Aweday Town,83,60,17,160
Tir,5th,2010,Oromia,North Shewa,Aleiltu,75,79,7,161
Nehase,12th,2010,Oromia,East Shewa,Dugda,75,39,68,182
Nehase,12th,2009,Oromia,East Hararge,Jarso,38,3,53,94
Yekatit,6th,2010,Oromia,West Wellega,Ayira,79,38,87,204
Megabit,7th,2009,Oromia,North Shewa,Jido,93,2,34,129
Hedar,3rd,2010,Oromia,Arsi,Enkelo Wabe,47,65,76,188
Hedar,3rd,2010,Oromia,Horo Gudru Wellega,Abe Dengoro,67,46,98,211
Nehase,12th,2010,Oromia,Borena,El Way,34,93,39,166
Tir,5th,2011,Oromia,Horo Gudru Wellega,Jima Geneti,83,19,50,152
Tir,5th,2011,Oromia,Borena,Gomole,31,56,9,96
Meskerem,1st,2010,Oromia,West Shewa,Tikur Enchini,19,58,19,96
Nehase,12th,2009,Oromia,East Hararge,Babile Woreda,40,11,71,122
Tahesas,4th,2011,Oromia,West Arsi,Shala,99,62,26,187
Sene,10th,2009,Oromia,Sebeta Town,Sebeta Town,65,94,50,209
Tahesas,4th,2010,Oromia,West Wellega,Boji Dermeji,5,8,79,92
Meskerem,1st,2011,Oromia,North Shewa,Aleiltu,50,33,31,114
Miyazia,8th,2009,Oromia,Qeleme Wellega,Dambi Dollo,41,77,41,159
Miyazia,8th,2011,Oromia,Borena,Wachile,80,87,45,212
Teqemt,2nd,2011,Oromia,West Hararge,Habro,94,68,15,177
Nehase,12th,2009,Oromia,Jimma,Chora Boter,30,58,61,149
Miyazia,8th,2010,Oromia,West Wellega,Homa,17,21,21,59
Miyazia,8th,2010,Oromia,Arsi,Enkelo Wabe,91,63,69,223
Tir,5th,2010,Oromia,West Shewa,Liban Jawi,44,26,27,97
Nehase,12th,2010,Oromia,West Hararge,Chiro Town,69,83,90,242
Teqemt,2nd,2011,Oromia,West Arsi,Gedeb Asasa,87,85,28,200
Nehase,12th,2010,Oromia,Arsi,Ludehetosa,54,5,74,133
Sene,10th,2010,Oromia,West Arsi,Gambo Hospital,25,20,97,142
Sene,10th,2011,Oromia,Ilu Aba Bora,Halu,23,14,44,81
Meskerem,1st,2011,Oromia,Arsi,Robe,17,38,87,142
Tir,5th,2011,Oromia,Ilu Aba Bora,Metu Town,24,42,13,79
Megabit,7th,2011,Oromia,Guji,Goro Dola,76,88,14,178
Yekatit,6th,2011,Oromia,West Wellega,Gimbi Rural,17,45,19,81
Tahesas,4th,2010,Oromia,Ilu Aba Bora,Yayu,45,1,30,76
Nehase,12th,2009,Oromia,West Hararge,Guba Qoricha,70,61,74,205
Nehase,12th,2010,Oromia,Qeleme Wellega,Dambi Dolo Hospital,82,92,92,266
Megabit,7th,2009,Oromia,Guji,Girja,28,85,98,211
Nehase,12th,2009,Oromia,North Shewa,Degem,59,45,18,122
Nehase,12th,2009,Oromia,West Shewa,Ginde Beret,16,42,74,132
Miyazia,8th,2011,Oromia,Jimma,Omo Nada Hospital,47,2,73,122
Hamle,11th,2009,Oromia,East Hararge,Deder,33,95,16,144
Ginbot,9th,2011,Oromia,Woliso Town,Woliso Town,34,33,0,67
Tahesas,4th,2011,Oromia,Ilu Aba Bora,Nono Sele,11,77,19,107
Nehase,12th,2009,Oromia,Arsi,Aseko,92,76,16,184
Nehase,12th,2009,Oromia,South West Shewa,Woliso Town,50,16,96,162
Ginbot,9th,2010,Oromia,West Shewa,Ejersa Lafo,3,10,42,55
Tir,5th,2011,Oromia,East Wellega,Kiremu,4,54,24,82
Ginbot,9th,2011,Oromia,West Wellega,Genji,18,50,34,102
Ginbot,9th,2009,Oromia,West Hararge,Oda Bultum,4,30,39,73
Hamle,11th,2009,Oromia,Bale,Agarfa,72,71,92,235
Meskerem,1st,2010,Oromia,South West Shewa,Tole,59,76,21,156
Hamle,11th,2009,Oromia,South West Shewa,Kersana Malima,43,64,14,121
Hamle,11th,2010,Oromia,East Hararge,Fedis,83,29,30,142
Yekatit,6th,2009,Oromia,Bale,Seweyna,89,58,46,193
Megabit,7th,2010,Oromia,West Shewa,Inchini Hospital,93,30,0,123
Yekatit,6th,2011,Oromia,Qeleme Wellega,Hawa Gelan,25,63,20,108
Yekatit,6th,2009,Oromia,West Shewa,Ambo Hospital,74,36,79,189
Yekatit,6th,2009,Oromia,Arsi,Bale Gesgara,0,50,3,53
Nehase,12th,2010,Oromia,Buno Bedele,Bedele Zuriya,49,37,30,116
Miyazia,8th,2010,Oromia,Jimma,Kersa,37,37,86,160
Miyazia,8th,2011,Oromia,East Wellega,Gudeyabila,77,5,51,133
Ginbot,9th,2010,Oromia,East Wellega,Guto Gida,35,37,82,154
Tahesas,4th,2011,Oromia,Bale,Ginir Town,36,61,55,152
Megabit,7th,2009,Oromia,East Hararge,Haromaya Hospital,93,17,35,145
Nehase,12th,2010,Oromia,West Shewa,Ginde Beret,82,10,28,120
Tir,5th,2010,Oromia,Ilu Aba Bora,Bure,50,64,61,175
Tahesas,4th,2010,Oromia,Bale,Dawe Qachen,13,77,89,179
Ginbot,9th,2011,Oromia,Guji,Bore,67,76,3,146
Ginbot,9th,2010,Oromia,East Shewa,Olanciti Hospital,94,7,74,175
Teqemt,2nd,2010,Oromia,East Hararge,Chelenko Hospital,47,69,42,158
Tir,5th,2011,Oromia,Jimma,Omonada,69,6,70,145
Sene,10th,2009,Oromia,Qeleme Wellega,Dale Wabera,23,87,69,179
Tir,5th,2010,Oromia,Arsi,Guna,84,3,59,146
Teqemt,2nd,2011,Oromia,Borena,Moyale Hospital,8,91,9,108
Tir,5th,2011,Oromia,East Hararge,Deder,18,86,55,159
Tir,5th,2011,Oromia,North Shewa,Yaya Gulele,49,20,50,119
Yekatit,6th,2010,Oromia,Horo Gudru Wellega,Shambu Hospital,99,42,58,199
Hamle,11th,2010,Oromia,West Arsi,Hebal Arsi,9,63,51,123
Yekatit,6th,2010,Oromia,Guji,Saba Boru,24,98,67,189
Megabit,7th,2009,Oromia,Bale,Delo Mena,69,33,15,117
Miyazia,8th,2010,Oromia,Borena,Yabelo,16,4,30,50
Sene,10th,2010,Oromia,East Shewa,Bora,0,11,33,44
Miyazia,8th,2009,Oromia,East Hararge,Haromaya Hospital,96,6,52,154
Meskerem,1st,2010,Oromia,Jimma,Tiro Afeta,13,47,29,89
Tir,5th,2011,Oromia,West Guji,Kercha,23,12,27,62
Yekatit,6th,2009,Oromia,Bale,Robe Town,15,32,54,101
Teqemt,2nd,2010,Oromia,North Shewa,Degem,32,43,30,105
Megabit,7th,2009,Oromia,Arsi,Gololcha,94,31,49,174
Meskerem,1st,2011,Oromia,North Shewa,Yaya Gulele,36,90,77,203
Yekatit,6th,2011,Oromia,Borena,Arero,64,17,2,83
Sene,10th,2009,Oromia,East Hararge,Deder,12,37,26,75
Yekatit,6th,2010,Oromia,East Wellega,Limu,55,50,2,107
Teqemt,2nd,2010,Oromia,Jimma,Setema,48,2,53,103
Yekatit,6th,2009,Oromia,Guji,Saba Boru,44,9,20,73
Tahesas,4th,2011,Oromia,South West Shewa,Ilu,39,59,91,189
Yekatit,6th,2009,Oromia,Qeleme Wellega,Laloqile,17,2,67,86
Nehase,12th,2009,Oromia,Arsi,Ludehetosa,77,38,94,209
Hedar,3rd,2010,Oromia,West Guji,Kercha Hospital,31,69,98,198
Megabit,7th,2009,Oromia,Finfine Zuria,Holeta,71,67,51,189
Megabit,7th,2009,Oromia,Arsi,Bale Gesgara,9,10,4,23
Ginbot,9th,2010,Oromia,West Hararge,Hawi Gudina,17,73,30,120
Meskerem,1st,2010,Oromia,Guji,Hambela Wamena,98,80,12,190
Yekatit,6th,2011,Oromia,Guji,Negele Town,13,52,23,88
Tahesas,4th,2011,Oromia,Jimma,Guma,94,78,4,176
Yekatit,6th,2010,Oromia,Arsi,Shirka,62,5,28,95
Miyazia,8th,2009,Oromia,East Wellega,Sibu Sire,11,62,85,158
Tir,5th,2009,Oromia,West Wellega,Qiltu Kara,10,30,45,85
Ginbot,9th,2011,Oromia,West Wellega,Lata Sibu,1,96,45,142
Sene,10th,2009,Oromia,East Hararge,Deder,42,69,74,185
Tahesas,4th,2010,Oromia,Ilu Aba Bora,Darimu,87,63,20,170
Ginbot,9th,2010,Oromia,Sululta Town,Sululta Town,52,36,34,122
Sene,10th,2010,Oromia,Arsi,Sire,23,7,84,114
Tahesas,4th,2010,Oromia,Bale,Seweyna,32,97,76,205
Ginbot,9th,2011,Oromia,Arsi,Digeluna Tijo,89,95,18,202
Sene,10th,2011,Oromia,Finfine Zuria,Sandefa,17,2,91,110
Tir,5th,2011,Oromia,East Hararge,Kurfa Chele,56,37,83,176
Ginbot,9th,2011,Oromia,Bale,Meda Welabu,78,74,85,237
Nehase,12th,2009,Oromia,East Wellega,Sasiga,30,41,10,81
Tahesas,4th,2011,Oromia,Assela Town,Assela Town,57,8,82,147
Tir,5th,2011,Oromia,Arsi,Bekoji Town,71,11,54,136
Tir,5th,2010,Oromia,Guji,Shakiso Town,92,62,15,169
Nehase,12th,2010,Oromia,East Hararge,Haromaya Hospital,23,55,26,104
Nehase,12th,2010,Oromia,Guji,Liben,64,44,25,133
Tir,5th,2011,Oromia,Dukem Town,Dukem Town,11,80,1,92
Hedar,3rd,2011,Oromia,West Wellega,Mene Sibu,7,50,45,102
Yekatit,6th,2010,Oromia,East Hararge,Goro Gutu,36,24,58,118
Yekatit,6th,2011,Oromia,East Hararge,Babile Woreda,15,28,31,74
Teqemt,2nd,2010,Oromia,Horo Gudru Wellega,Abay Chomen,75,92,39,206
Tir,5th,2010,Oromia,East Shewa,Gimbichu,56,2,73,131
Megabit,7th,2011,Oromia,East Shewa,Lomme,93,98,28,219
Hedar,3rd,2011,Oromia,West Hararge,Daro Lebu,53,85,49,187
Yekatit,6th,2010,Oromia,West Guji,Biebirsa Kojowa,77,6,21,104
Miyazia,8th,2010,Oromia,West Wellega,Lata Sibu,19,97,53,169
Tir,5th,2011,Oromia,Arsi,Amigna,32,38,12,82
Tir,5th,2010,Oromia,Guji,Adola Town,87,60,74,221
Tir,5th,2009,Oromia,Arsi,Digeluna Tijo,60,7,78,145
Sene,10th,2009,Oromia,Borena,Dhas,77,85,59,221
Megabit,7th,2009,Oromia,West Arsi,Kokosa,63,71,22,156
Ginbot,9th,2010,Oromia,South West Shewa,St.Luke Hospital,42,69,59,170
Meskerem,1st,2011,Oromia,Borena,Moyale,22,10,98,130
Yekatit,6th,2010,Oromia,West Wellega,Boji Cheqorsa,69,20,66,155
Tir,5th,2010,Oromia,South West Shewa,Ilu,31,28,3,62
Tir,5th,2011,Oromia,Bishoftu Town,Bishoftu Town,99,83,77,259
Teqemt,2nd,2011,Oromia,East Wellega,Kiremu,55,35,19,109
Hedar,3rd,2011,Oromia,Buno Bedele,Diga,79,33,12,124
Megabit,7th,2010,Oromia,West Guji,Bule Hora Hospital,23,12,92,127
Nehase,12th,2009,Oromia,West Hararge,Chiro Hospital,43,25,41,109
Meskerem,1st,2011,Oromia,Ilu Aba Bora,Doreni,75,23,23,121
Meskerem,1st,2011,Oromia,Bale,Seweyna,81,1,6,88
Yekatit,6th,2010,Oromia,West Hararge,Oda Bultum,63,37,25,125
Megabit,7th,2011,Oromia,East Shewa,Olanciti Hospital,23,12,80,115
Megabit,7th,2010,Oromia,West Shewa,Ambo Hospital,51,66,97,214
Teqemt,2nd,2010,Oromia,Bale,Gololcha,41,63,2,106
Tahesas,4th,2011,Oromia,West Wellega,Boji Cheqorsa,16,78,29,123
Meskerem,1st,2010,Oromia,Arsi,Enkelo Wabe,43,35,24,102
Hedar,3rd,2011,Oromia,Jimma,Limu Hospital,54,60,98,212
Teqemt,2nd,2011,Oromia,Buno Bedele,Chewaqa,48,20,7,75
Teqemt,2nd,2010,Oromia,Jimma,Kersa,76,79,65,220
Hedar,3rd,2010,Oromia,Horo Gudru Wellega,Horro Buluk,34,35,66,135
Miyazia,8th,2009,Oromia,Jimma,Gera,3,9,40,52
Miyazia,8th,2011,Oromia,Qeleme Wellega,Gidami,34,28,7,69
Tahesas,4th,2011,Oromia,Jimma,Mana,78,25,53,156
Miyazia,8th,2011,Oromia,Guji,Goro Dola,3,85,21,109
Tir,5th,2009,Oromia,West Wellega,Boji Cheqorsa,49,98,49,196
Megabit,7th,2009,Oromia,Arsi,Bale Gesgara,52,80,20,152
Sene,10th,2010,Oromia,North Shewa,Dera Hospital,9,34,15,58
Ginbot,9th,2009,Oromia,Jimma,Gomma,22,56,76,154
Megabit,7th,2010,Oromia,East Hararge,Kurfa Chele,91,81,11,183
Megabit,7th,2009,Oromia,West Arsi,Kofele,45,65,34,144
Miyazia,8th,2009,Oromia,Ilu Aba Bora,Metu Town,12,48,86,146
Nehase,12th,2010,Oromia,East Wellega,Gudeyabila,45,75,49,169
Megabit,7th,2009,Oromia,Guji,Goro Dola,71,23,76,170
Yekatit,6th,2009,Oromia,Jimma,Gomma,33,50,51,134
Megabit,7th,2009,Oromia,Arsi,Munesa,90,59,97,246
Miyazia,8th,2010,Oromia,Qeleme Wellega,Gawo Qebe,74,23,40,137
Miyazia,8th,2011,Oromia,Horo Gudru Wellega,Horro Buluk,27,14,32,73
Ginbot,9th,2011,Oromia,South West Shewa,Becho,23,68,71,162
Teqemt,2nd,2011,Oromia,North Shewa,Abichugna,23,46,35,104
Sene,10th,2009,Oromia,Borena,Dubluk,27,13,53,93
Tahesas,4th,2010,Oromia,Holeta Town,Holeta Town,31,9,62,102
Nehase,12th,2009,Oromia,Ilu Aba Bora,Algesachi,93,76,37,206
Sene,10th,2011,Oromia,West Arsi,Dodola Rural,61,30,18,109
Tir,5th,2011,Oromia,East Hararge,Babile,93,65,52,210
Sene,10th,2011,Oromia,Finfine Zuria,Berreh,28,19,80,127
Sene,10th,2011,Oromia,Qeleme Wellega,Jimma Horo,45,85,48,178
Sene,10th,2010,Oromia,Borena,Gomole,65,0,75,140
Miyazia,8th,2010,Oromia,West Wellega,Nejo Rural,76,17,20,113
Hamle,11th,2009,Oromia,West Hararge,Chiro Zuriya,27,41,50,118
Tir,5th,2009,Oromia,Jimma,Tiro Afeta,94,31,64,189
Teqemt,2nd,2011,Oromia,West Wellega,Gimbi Public  Hospital,65,67,4,136
Megabit,7th,2010,Oromia,West Guji,Bule Hora Toun,35,64,59,158
Yekatit,6th,2009,Oromia,Arsi,Shirka,97,77,68,242
Ginbot,9th,2011,Oromia,Horo Gudru Wellega,Horro Buluk,82,35,20,137
Miyazia,8th,2011,Oromia,East Hararge,Gole Oda,90,36,97,223
Teqemt,2nd,2011,Oromia,Arsi,Seru,63,19,76,158
Nehase,12th,2009,Oromia,East Wellega,Limu,88,69,59,216
Hedar,3rd,2010,Oromia,Qeleme Wellega,Seyo,81,92,91,264
Hedar,3rd,2011,Oromia,West Arsi,Shashemene Rural,1,84,61,146
Tahesas,4th,2011,Oromia,Qeleme Wellega,Gidami Hosp,78,53,9,140
Meskerem,1st,2010,Oromia,Finfine Zuria,Holeta,37,43,54,134
Hamle,11th,2010,Oromia,East Hararge,Chinakesen,23,39,18,80
Teqemt,2nd,2011,Oromia,West Wellega,Babo Gembel,17,58,62,137
Tir,5th,2009,Oromia,Guji,Girja,37,12,88,137
Teqemt,2nd,2010,Oromia,East Hararge,Deder Hospital,61,99,14,174
Megabit,7th,2010,Oromia,South West Shewa,Seden Sodo,94,7,75,176
Meskerem,1st,2011,Oromia,Arsi,Digeluna Tijo,27,0,75,102
Miyazia,8th,2009,Oromia,East Hararge,Bisidimo Hospital,36,94,4,134
Ginbot,9th,2010,Oromia,East Wellega,Sibu Sire,14,0,24,38
Megabit,7th,2011,Oromia,West Shewa,Gindeberet Hospital,84,19,3,106
Nehase,12th,2009,Oromia,West Shewa,Meta Waliqite,5,78,47,130
Sene,10th,2009,Oromia,Borena,Moyale,72,83,52,207
Meskerem,1st,2010,Oromia,East Hararge,Bisidimo Hospital,32,73,77,182
Sene,10th,2011,Oromia,West Guji,Bule Hora Toun,77,38,61,176
Megabit,7th,2010,Oromia,East Wellega,Jimma Arjo,93,79,34,206
Tahesas,4th,2010,Oromia,West Wellega,Seyo Nole,29,90,91,210
Tir,5th,2009,Oromia,East Wellega,Sibu Sire,55,89,48,192
Teqemt,2nd,2010,Oromia,Bale,Ginir Town,8,69,37,114
Ginbot,9th,2010,Oromia,Borena,Arero,65,95,12,172
Miyazia,8th,2011,Oromia,West Arsi,Kofele,86,35,92,213
Hedar,3rd,2011,Oromia,Bale,Meda Welabu,87,80,95,262
Tahesas,4th,2010,Oromia,Arsi,Bale Gesgara,14,65,46,125
Yekatit,6th,2009,Oromia,Lege Dadi Lege Tafo Town,Lege Dadi Lege Tafo Town,89,57,42,188
Teqemt,2nd,2011,Oromia,Bale,Dawe Qachen,59,97,8,164
Tir,5th,2010,Oromia,North Shewa,Hidabu Abote,77,48,54,179
Teqemt,2nd,2011,Oromia,Guji,Bore Hospital,57,77,35,169
Yekatit,6th,2011,Oromia,West Arsi,Dodola Rural,13,79,77,169
Tir,5th,2009,Oromia,East Wellega,Sasiga,6,69,26,101
Teqemt,2nd,2011,Oromia,Ilu Aba Bora,Darimu,19,92,39,150
Sene,10th,2009,Oromia,Arsi,Amigna,57,62,25,144
Teqemt,2nd,2011,Oromia,North Shewa,Yaya Gulele,41,84,74,199
Ginbot,9th,2010,Oromia,West Wellega,Mene Sibu,79,57,90,226
Hamle,11th,2009,Oromia,Horo Gudru Wellega,Abay Chomen,77,76,83,236
Tir,5th,2009,Oromia,Horo Gudru Wellega,Jarte Jardga,26,71,32,129
Hedar,3rd,2010,Oromia,West Wellega,Boji Dermeji,90,82,64,236
Hedar,3rd,2011,Oromia,Jimma,Omonada,29,74,50,153
Hamle,11th,2010,Oromia,West Wellega,Gimbi Adventist Hospital,74,7,19,100
Nehase,12th,2010,Oromia,Horo Gudru Wellega,Abay Chomen,20,53,62,135
Sene,10th,2009,Oromia,West Arsi,Gambo Hospital,56,61,74,191
Ginbot,9th,2009,Oromia,Arsi,Bale Gesgara,27,32,2,61
Megabit,7th,2011,Oromia,West Wellega,Lalo Asabi,85,90,19,194
Hamle,11th,2010,Oromia,West Guji,Suro Barguda,38,30,83,151
Yekatit,6th,2010,Oromia,West Guji,Bule Hora,67,44,29,140
Miyazia,8th,2011,Oromia,South West Shewa,Wonchi,79,87,6,172
Ginbot,9th,2009,Oromia,West Wellega,Mene Sibu,28,93,77,198
Nehase,12th,2009,Oromia,Guji,Goro Dola,9,21,94,124
Teqemt,2nd,2011,Oromia,West Wellega,Qiltu Kara,9,35,55,99
Tir,5th,2011,Oromia,North Shewa,Fichetown,82,0,73,155
Teqemt,2nd,2011,Oromia,West Arsi,Dodola  Hospital,18,99,66,183
Tir,5th,2010,Oromia,West Arsi,Adaba,21,43,84,148
Hamle,11th,2009,Oromia,West Wellega,Lata Sibu,30,31,67,128
Megabit,7th,2010,Oromia,West Hararge,Chiro Hospital,92,53,94,239
Hamle,11th,2010,Oromia,West Arsi,Shashemene Rural,29,19,56,104
Teqemt,2nd,2010,Oromia,East Hararge,Gursum,27,38,70,135
Yekatit,6th,2009,Oromia,East Hararge,Chinakesen,27,73,64,164
Meskerem,1st,2010,Oromia,West Wellega,Haru,39,94,37,170
Tir,5th,2011,Oromia,Shashamane Town,Shashamane Town,15,40,31,86
Sene,10th,2009,Oromia,West Shewa,Adea Berga,53,85,34,172
Sene,10th,2011,Oromia,Jimma,Tiro Afeta,98,85,37,220
Meskerem,1st,2011,Oromia,North Shewa,Yaya Gulele,86,10,80,176
Megabit,7th,2009,Oromia,Arsi,Deksis,84,93,55,232
Hamle,11th,2010,Oromia,West Shewa,Ambo Hospital,49,97,5,151
Teqemt,2nd,2010,Oromia,West Wellega,Begi,72,38,49,159
Yekatit,6th,2009,Oromia,East Wellega,Gida Ayana,83,86,83,252
Miyazia,8th,2011,Oromia,West Wellega,Nejo Rural,81,96,87,264
Tahesas,4th,2011,Oromia,Guji,Negele Town,10,74,85,169
Sene,10th,2010,Oromia,East Wellega,Kiremu,87,34,46,167
Megabit,7th,2009,Oromia,East Hararge,Bisidimo Hospital,75,2,67,144
Hedar,3rd,2010,Oromia,West Arsi,Shashemene Rural,69,77,82,228
Hamle,11th,2010,Oromia,West Arsi,Adaba,15,56,70,141
Megabit,7th,2010,Oromia,West Wellega,Mendi Hospital,39,77,27,143
Teqemt,2nd,2011,Oromia,North Shewa,Debre Libanos,8,63,57,128
Tir,5th,2010,Oromia,West Shewa,Ambo,6,73,99,178
Yekatit,6th,2010,Oromia,East Hararge,Deder,85,4,42,131
Yekatit,6th,2009,Oromia,West Shewa,Dano,6,41,83,130
Ginbot,9th,2010,Oromia,East Wellega,Sibu Sire,59,46,25,130
Miyazia,8th,2011,Oromia,Arsi,Limuna Bilbilo,8,34,79,121
Yekatit,6th,2009,Oromia,West Shewa,Metarobi,40,6,31,77
Ginbot,9th,2011,Oromia,Horo Gudru Wellega,Hababo Guduru,85,66,5,156
Meskerem,1st,2011,Oromia,Qeleme Wellega,Gawo Qebe,35,31,12,78
Miyazia,8th,2011,Oromia,Qeleme Wellega,Anfilo,20,2,76,98
Meskerem,1st,2010,Oromia,Bale,Berbere,54,34,5,93
Sene,10th,2010,Oromia,West Arsi,Siraro,75,32,96,203
Teqemt,2nd,2011,Oromia,East Wellega,Jimma Arjo,39,92,54,185
Sene,10th,2010,Oromia,West Arsi,Arsi Negele Rural,29,8,10,47
Teqemt,2nd,2011,Oromia,Ilu Aba Bora,Yayu,92,69,40,201
Tahesas,4th,2010,Oromia,North Shewa,Debre Libanos,71,75,0,146
Sene,10th,2009,Oromia,Guji,Wadara,16,12,52,80
Tir,5th,2009,Oromia,South West Shewa,Kersana Malima,59,24,4,87
Nehase,12th,2009,Oromia,West Shewa,Midakegni,26,19,65,110
Teqemt,2nd,2010,Oromia,East Hararge,Chelenko Hospital,37,92,0,129
Megabit,7th,2009,Oromia,South West Shewa,Kersana Malima,95,58,90,243
Nehase,12th,2009,Oromia,Ilu Aba Bora,Bure,33,67,78,178
Miyazia,8th,2010,Oromia,West Shewa,Tikur Enchini,96,1,29,126
Miyazia,8th,2011,Oromia,Sululta Town,Sululta Town,64,40,13,117
Hamle,11th,2009,Oromia,Jimma,Mana,22,53,98,173
Yekatit,6th,2009,Oromia,Sebeta Town,Sebeta Town,57,78,2,137
Yekatit,6th,2010,Oromia,East Shewa,Gimbichu,71,11,75,157
Sene,10th,2011,Oromia,Borena,Moyale Hospital,71,9,5,85
Hedar,3rd,2010,Oromia,Ilu Aba Bora,Metu Town,72,8,52,132
Miyazia,8th,2011,Oromia,West Wellega,Nole Kaba,4,66,14,84
Nehase,12th,2009,Oromia,South West Shewa,Ameya,67,4,43,114
Tir,5th,2011,Oromia,West Wellega,Lata Sibu,69,58,48,175
Hamle,11th,2010,Oromia,South West Shewa,Goro,5,30,8,43
Miyazia,8th,2010,Oromia,West Hararge,Bedesa Town,73,48,52,173
Yekatit,6th,2009,Oromia,West Hararge,Habro,60,83,18,161
Miyazia,8th,2009,Oromia,Qeleme Wellega,Gidami,13,7,77,97
Sene,10th,2011,Oromia,Finfine Zuria,Sebeta Awas,54,38,68,160
Yekatit,6th,2009,Oromia,East Hararge,Chelenko Hospital,19,88,94,201
Tir,5th,2011,Oromia,West Guji,Gelana,44,50,80,174
Nehase,12th,2009,Oromia,West Wellega,Qiltu Kara,81,98,98,277
Meskerem,1st,2010,Oromia,East Shewa,Gimbichu,46,23,76,145
Ginbot,9th,2010,Oromia,Buno Bedele,Chewaqa,26,79,84,189
Miyazia,8th,2011,Oromia,West Shewa,Bako Hospital,44,16,86,146
Hamle,11th,2010,Oromia,West Arsi,Kokosa,77,67,71,215
Ginbot,9th,2011,Oromia,North Shewa,Wuchale,28,64,79,171
Hedar,3rd,2010,Oromia,Arsi,Seru,80,96,96,272
Tahesas,4th,2011,Oromia,North Shewa,Dera Hospital,32,82,21,135
Miyazia,8th,2009,Oromia,East Shewa,Matahara,98,72,17,187
Tahesas,4th,2011,Oromia,West Wellega,Jarso,97,68,1,166
Sene,10th,2011,Oromia,Buno Bedele,Dedesa,8,55,21,84
Hedar,3rd,2010,Oromia,Borena,Gomole,87,76,39,202
Teqemt,2nd,2010,Oromia,Guji,Adola Hospital,61,80,81,222
Ginbot,9th,2010,Oromia,West Shewa,Dendi,19,30,41,90
Sene,10th,2011,Oromia,Arsi,Robe,28,61,47,136
Nehase,12th,2010,Oromia,Guji,Wadara,78,67,60,205
Megabit,7th,2009,Oromia,West Shewa,Gojo Hospital,56,76,66,198
Teqemt,2nd,2011,Oromia,Horo Gudru Wellega,Abay Chomen,75,35,80,190
Yekatit,6th,2011,Oromia,Jimma,Limu Hospital,87,34,27,148
Hedar,3rd,2011,Oromia,Qeleme Wellega,Kake Hosp,40,10,68,118
Miyazia,8th,2010,Oromia,East Wellega,Nunu Qumba,31,25,9,65
Miyazia,8th,2010,Oromia,North Shewa,Dera,8,8,0,16
Miyazia,8th,2011,Oromia,North Shewa,Degem,31,97,36,164
Miyazia,8th,2010,Oromia,Ilu Aba Bora,Darimu,1,43,25,69
Ginbot,9th,2009,Oromia,East Wellega,Nunu Qumba,29,16,64,109
Meskerem,1st,2010,Oromia,West Shewa,Midakegni,70,63,30,163
Meskerem,1st,2011,Oromia,Horo Gudru Wellega,Abay Chomen,92,80,6,178
Tir,5th,2009,Oromia,West Wellega,Nejo Town,89,14,71,174
Megabit,7th,2011,Oromia,Guji,Liben,11,55,33,99
Nehase,12th,2010,Oromia,North Shewa,Kimbibit,15,79,86,180
Tahesas,4th,2011,Oromia,West Shewa,Ambo,29,73,30,132
Tahesas,4th,2011,Oromia,West Shewa,Inchini Hospital,45,32,87,164
Yekatit,6th,2009,Oromia,East Wellega,Limu,21,99,29,149
Meskerem,1st,2010,Oromia,Shashamane Town,Shashamane Town,25,86,81,192
Tahesas,4th,2010,Oromia,North Shewa,Yaya Gulele,32,95,56,183
Ginbot,9th,2011,Oromia,Guji,Uraga,50,47,48,145
Hedar,3rd,2011,Oromia,South West Shewa,Becho,18,16,21,55
Hedar,3rd,2011,Oromia,Qeleme Wellega,Gidami Hosp,7,19,25,51
Nehase,12th,2010,Oromia,Shashamane Town,Shashamane Town,32,33,55,120
Tir,5th,2009,Oromia,East Shewa,Gimbichu,5,27,33,65
Nehase,12th,2010,Oromia,Borena,El Way,30,54,9,93
Hamle,11th,2010,Oromia,Guji,Bore Hospital,72,12,71,155
Tahesas,4th,2010,Oromia,West Wellega,Genji,40,6,18,64
Miyazia,8th,2010,Oromia,Nekemte Town,Nekemte Town,10,76,45,131
Nehase,12th,2010,Oromia,Holeta Town,Holeta Town,96,90,68,254
Sene,10th,2009,Oromia,East Hararge,Midega Tole,50,97,14,161
Nehase,12th,2009,Oromia,Jimma Spe Town,Jimma Spe Town,11,22,44,77
Miyazia,8th,2011,Oromia,East Hararge,Kombolicha,47,51,77,175
Hedar,3rd,2010,Oromia,Buno Bedele,Boricha,21,86,79,186
Megabit,7th,2009,Oromia,Qeleme Wellega,Hawa Gelan,2,5,52,59
Miyazia,8th,2009,Oromia,West Arsi,Siraro,39,11,15,65
Tir,5th,2011,Oromia,West Wellega,Begi Hospital,57,34,7,98
Tir,5th,2009,Oromia,West Wellega,Nejo Rural,39,83,43,165
Hedar,3rd,2011,Oromia,Arsi,Sire,85,64,77,226
Miyazia,8th,2009,Oromia,North Shewa,Dera Hospital,61,96,54,211
Hedar,3rd,2010,Oromia,Buno Bedele,Bedele Zuriya,66,99,33,198
Megabit,7th,2011,Oromia,West Wellega,Gimbi Adventist Hospital,57,74,38,169
Sene,10th,2011,Oromia,West Arsi,Nensebo,69,64,28,161
Teqemt,2nd,2011,Oromia,West Wellega,Homa,84,0,46,130
Megabit,7th,2011,Oromia,Jimma,Omo Nada Hospital,0,53,15,68
Hamle,11th,2009,Oromia,West Hararge,Habro,28,1,20,49
Meskerem,1st,2011,Oromia,East Wellega,Gida Ayana,13,61,17,91
Miyazia,8th,2010,Oromia,North Shewa,Aleiltu,15,31,1,47
Yekatit,6th,2010,Oromia,Jimma,Gera,97,3,36,136
Meskerem,1st,2011,Oromia,West Wellega,Kundala,62,43,6,111
Nehase,12th,2009,Oromia,Jimma,B/Tolyi,50,21,81,152
Hedar,3rd,2011,Oromia,Bale,Ginir Town,67,61,64,192
Sene,10th,2010,Oromia,Buno Bedele,Meko,78,2,26,106
Yekatit,6th,2010,Oromia,Ilu Aba Bora,Yayu,33,70,30,133
Nehase,12th,2009,Oromia,North Shewa,Dera,3,82,69,154
Megabit,7th,2011,Oromia,Jimma,Kersa,35,52,9,96
Megabit,7th,2011,Oromia,East Hararge,Bedeno,4,23,41,68
Sene,10th,2010,Oromia,Arsi,Bale Gesgara,58,93,35,186
Megabit,7th,2010,Oromia,East Hararge,Bisidimo Hospital,76,57,4,137
Nehase,12th,2010,Oromia,Horo Gudru Wellega,Shambu Hospital,27,54,9,90
Sene,10th,2009,Oromia,Horo Gudru Wellega,Amuru,92,41,20,153
Meskerem,1st,2010,Oromia,West Wellega,Lalo Asabi,36,63,54,153
Tir,5th,2009,Oromia,West Guji,Hanbala,40,66,35,141
Megabit,7th,2009,Oromia,Qeleme Wellega,Gawo Qebe,17,93,26,136
Megabit,7th,2009,Oromia,Bale,Goro,71,73,87,231
Nehase,12th,2009,Oromia,East Hararge,Kumbi,40,78,97,215
Sene,10th,2011,Oromia,Horo Gudru Wellega,Amuru,64,67,15,146
Yekatit,6th,2009,Oromia,West Guji,Hanbala,9,63,10,82
Ginbot,9th,2010,Oromia,Robe Town,Robe Town,51,80,90,221
Hedar,3rd,2011,Oromia,East Hararge,Goro Gutu,26,23,39,88
Sene,10th,2010,Oromia,West Shewa,Midakegni,5,93,22,120
Tir,5th,2011,Oromia,South West Shewa,Tulu Bolo Hospital,44,24,80,148
Ginbot,9th,2010,Oromia,East Wellega,Sibu Sire,43,40,86,169
Meskerem,1st,2011,Oromia,West Wellega,Guliso,65,69,3,137
Tir,5th,2009,Oromia,Borena,Yabelo Rural,40,71,60,171
Hedar,3rd,2010,Oromia,West Shewa,Metarobi,47,81,46,174
Tir,5th,2011,Oromia,Dukem Town,Dukem Town,56,84,39,179
Teqemt,2nd,2010,Oromia,East Wellega,Wama Hagelo,43,63,84,190
Yekatit,6th,2010,Oromia,Borena,Yabelo,51,43,79,173
Megabit,7th,2010,Oromia,Horo Gudru Wellega,Jima Geneti,66,30,79,175
Sene,10th,2011,Oromia,Adama Special Town,Adama Town,66,99,78,243
Miyazia,8th,2010,Oromia,Qeleme Wellega,Seyo,26,64,6,96
Ginbot,9th,2010,Oromia,Jimma,Sigmo,84,36,45,165
Sene,10th,2011,Oromia,West Arsi,Kofele,65,60,90,215
Megabit,7th,2010,Oromia,Sebeta Town,Sebeta Town,3,27,79,109
Miyazia,8th,2011,Oromia,East Hararge,Chinakesen,43,86,88,217
Megabit,7th,2010,Oromia,Bale,Gololcha,79,48,85,212
Ginbot,9th,2011,Oromia,Ilu Aba Bora,Becho,64,94,45,203
Megabit,7th,2010,Oromia,West Wellega,Homa,40,19,90,149
Meskerem,1st,2011,Oromia,East Hararge,Babile,38,87,47,172
Nehase,12th,2009,Oromia,Borena,Dhas,16,73,25,114
Ginbot,9th,2010,Oromia,North Shewa,Were Jarso,81,49,65,195
Hedar,3rd,2011,Oromia,West Shewa,Ginde Beret,83,4,81,168
Megabit,7th,2009,Oromia,East Shewa,Boset,92,68,81,241
Hamle,11th,2010,Oromia,Guji,Dima,74,3,25,102
Hamle,11th,2009,Oromia,East Shewa,Liben,30,7,61,98
Meskerem,1st,2011,Oromia,East Hararge,Goro Gutu,4,92,80,176
Hedar,3rd,2010,Oromia,North Shewa,Fiche Hospital,35,61,3,99
Sene,10th,2009,Oromia,Jimma,Sekoru,66,83,52,201
Miyazia,8th,2011,Oromia,Arsi,Digeluna Tijo,81,97,7,185
Yekatit,6th,2010,Oromia,Finfine Zuria,Berreh,87,87,30,204
Megabit,7th,2011,Oromia,Gelan Town,Gelan Town,87,54,59,200
Ginbot,9th,2009,Oromia,Jimma,Mancho,4,99,10,113
Miyazia,8th,2010,Oromia,Bale,Raitu,47,42,55,144
Hamle,11th,2009,Oromia,Buno Bedele,Bedele Hospital,54,7,35,96
Megabit,7th,2011,Oromia,South West Shewa,Goro,40,16,95,151
Miyazia,8th,2010,Oromia,West Wellega,Boji Cheqorsa,72,59,47,178
Hamle,11th,2009,Oromia,Bale,Dawe Qachen,16,26,4,46
Tir,5th,2011,Oromia,Guji,Liben,68,14,54,136
Miyazia,8th,2010,Oromia,Arsi,Seru,18,47,9,74
Megabit,7th,2009,Oromia,West Wellega,Kundala,80,98,73,251
Tahesas,4th,2010,Oromia,Finfine Zuria,Walmera,76,16,70,162
Meskerem,1st,2010,Oromia,Guji,Adola Reda,47,14,92,153
Tir,5th,2011,Oromia,Guji,Adola Town,79,44,26,149
Miyazia,8th,2011,Oromia,Guji,Adola Hospital,11,64,47,122
Yekatit,6th,2011,Oromia,West Shewa,Ambo,57,38,79,174
Hedar,3rd,2010,Oromia,East Shewa,Liben,19,48,35,102
Yekatit,6th,2011,Oromia,Arsi,Sire,66,65,30,161
Miyazia,8th,2010,Oromia,Horo Gudru Wellega,Jima Geneti,83,29,84,196
Meskerem,1st,2010,Oromia,Arsi,Digeluna Tijo,97,71,62,230
Meskerem,1st,2010,Oromia,East Hararge,Gole Oda,29,2,80,111
Meskerem,1st,2010,Oromia,Bale,Gasera,34,51,43,128
Megabit,7th,2009,Oromia,Dukem Town,Dukem Town,52,0,18,70
Nehase,12th,2009,Oromia,West Wellega,Boji Dermeji,39,11,39,89
Tahesas,4th,2011,Oromia,East Hararge,Bedeno,86,57,93,236
Tir,5th,2011,Oromia,West Hararge,Habro,10,99,86,195
Ginbot,9th,2011,Oromia,Jimma,Setema Hospital,37,63,5,105
Sene,10th,2009,Oromia,Jimma,Chora Boter,24,20,0,44
Tir,5th,2011,Oromia,West Shewa,Gedo Hospital,19,30,99,148
Tir,5th,2009,Oromia,East Hararge,Kombolicha,65,97,37,199
Tir,5th,2010,Oromia,West Shewa,Gojo Hospital,17,69,42,128
Tir,5th,2011,Oromia,West Hararge,Tulo,38,0,66,104
Tir,5th,2010,Oromia,Jimma,Limu Hospital,19,91,41,151
Sene,10th,2010,Oromia,East Wellega,Haro Limu,48,94,53,195
Yekatit,6th,2010,Oromia,Sululta Town,Sululta Town,24,86,34,144
Tahesas,4th,2011,Oromia,Borena,Dire,71,75,31,177
Miyazia,8th,2011,Oromia,West Guji,Mkelka Soda,22,46,74,142
Hedar,3rd,2011,Oromia,Bale,Raitu,20,60,17,97
Teqemt,2nd,2011,Oromia,Borena,Arero,33,55,31,119
Miyazia,8th,2009,Oromia,Buno Bedele,Diga,53,30,59,142
Hedar,3rd,2011,Oromia,Horo Gudru Wellega,Jarte Jardga,86,62,91,239
Tir,5th,2010,Oromia,Bale,Seweyna,20,62,98,180
Sene,10th,2009,Oromia,Borena,Moyale Hospital,88,68,33,189
Nehase,12th,2010,Oromia,West Shewa,Chelia,51,29,87,167
Ginbot,9th,2011,Oromia,East Hararge,Chelenko Hospital,57,41,72,170
Hamle,11th,2010,Oromia,West Arsi,Dodola Rural,39,52,86,177
Megabit,7th,2009,Oromia,West Wellega,Lalo Asabi,45,15,9,69
Teqemt,2nd,2011,Oromia,East Wellega,Nunu Qumba,36,68,36,140
Teqemt,2nd,2010,Oromia,Bale,Raitu,31,61,30,122
Sene,10th,2009,Oromia,East Shewa,Dugda,47,41,80,168
Ginbot,9th,2011,Oromia,Buno Bedele,Bedele Hospital,37,0,92,129
Hedar,3rd,2011,Oromia,East Wellega,Gobu Seyo,98,9,49,156
Tir,5th,2010,Oromia,Arsi,Limuna Bilbilo,21,57,48,126
Megabit,7th,2009,Oromia,West Wellega,Lalo Asabi,83,38,0,121
Tahesas,4th,2011,Oromia,West Arsi,Kokosa,0,81,12,93
Tahesas,4th,2011,Oromia,Ilu Aba Bora,Metu Town,78,45,31,154
Megabit,7th,2009,Oromia,West Shewa,Ginde Beret,57,43,14,114
Yekatit,6th,2010,Oromia,West Hararge,Hawi Gudina,59,37,70,166
Ginbot,9th,2011,Oromia,East Hararge,Babile,75,74,3,152
Hedar,3rd,2011,Oromia,Qeleme Wellega,Anfilo,20,67,80,167
Sene,10th,2010,Oromia,West Wellega,Kundala,78,85,61,224
Teqemt,2nd,2011,Oromia,Borena,Dhas,89,74,28,191
Megabit,7th,2009,Oromia,East Shewa,Matahara,97,68,82,247
Tir,5th,2011,Oromia,West Shewa,Metarobi,45,78,36,159
Teqemt,2nd,2011,Oromia,West Shewa,Ginde Beret,75,17,55,147
Ginbot,9th,2010,Oromia,West Wellega,Boji Dermeji,9,99,16,124
Hedar,3rd,2011,Oromia,West Wellega,Nole Kaba,76,85,57,218
Hamle,11th,2010,Oromia,West Wellega,Begi,9,39,17,65
Teqemt,2nd,2010,Oromia,West Shewa,Chelia,12,80,41,133
Miyazia,8th,2010,Oromia,East Shewa,Gimbichu,87,86,47,220
Sene,10th,2010,Oromia,North Shewa,Abichugna,76,82,98,256
Tahesas,4th,2010,Oromia,West Hararge,Gemechis,74,6,67,147
Tahesas,4th,2010,Oromia,Ilu Aba Bora,Doreni,71,43,6,120
Nehase,12th,2009,Oromia,West Wellega,Nejo Hospital,48,89,68,205
Teqemt,2nd,2011,Oromia,West Arsi,Siraro,90,12,62,164
Megabit,7th,2009,Oromia,East Shewa,Gimbichu,21,13,62,96
Miyazia,8th,2010,Oromia,East Hararge,Kombolicha,22,63,66,151
Megabit,7th,2011,Oromia,West Wellega,Nejo Rural,12,5,77,94
Sene,10th,2009,Oromia,Guji,Anna Sora,7,2,84,93
Megabit,7th,2011,Oromia,North Shewa,Degem,44,36,74,154
Yekatit,6th,2010,Oromia,Jimma,Dedo,39,29,90,158
Sene,10th,2010,Oromia,West Guji,Bule Hora,22,31,42,95
Sene,10th,2010,Oromia,East Hararge,Garemuleta Hospital,88,98,8,194
Tir,5th,2009,Oromia,Qeleme Wellega,Anfilo,71,18,98,187
Sene,10th,2010,Oromia,Bale,Berbere,97,2,72,171
Megabit,7th,2010,Oromia,West Hararge,Gelemso Hospital,76,79,58,213
Teqemt,2nd,2010,Oromia,East Wellega,Sasiga,61,67,96,224
Megabit,7th,2010,Oromia,West Wellega,Gimbi Adventist Hospital,76,64,75,215
Tahesas,4th,2011,Oromia,West Guji,Bule Hora,26,51,63,140
Ginbot,9th,2010,Oromia,Woliso Town,Woliso Town,21,99,79,199
Yekatit,6th,2009,Oromia,West Wellega,Lalo Asabi,32,74,49,155
Meskerem,1st,2011,Oromia,Horo Gudru Wellega,Shambu Town,61,99,72,232
Sene,10th,2011,Oromia,East Wellega,Limu,67,28,46,141
Hedar,3rd,2010,Oromia,West Hararge,Tulo,58,36,76,170
Miyazia,8th,2009,Oromia,Qeleme Wellega,Anfilo,4,71,14,89
Tir,5th,2011,Oromia,West Hararge,Oda Bultum,21,55,51,127
Nehase,12th,2010,Oromia,North Shewa,Jido,37,1,10,48
Teqemt,2nd,2011,Oromia,Jimma,Kersa,98,13,13,124
Hedar,3rd,2011,Oromia,West Wellega,Gimbi Public  Hospital,42,12,31,85
Hedar,3rd,2010,Oromia,Borena,Dhas,34,89,32,155
Meskerem,1st,2011,Oromia,Jimma,O/Beyam,60,26,90,176
Ginbot,9th,2009,Oromia,West Arsi,Bishan Guracha Town,36,94,62,192
Ginbot,9th,2010,Oromia,West Shewa,Ginde Beret,51,88,4,143
Yekatit,6th,2011,Oromia,Qeleme Wellega,Hawa Gelan,8,93,23,124
Sene,10th,2010,Oromia,Borena,El Way,57,8,15,80
Megabit,7th,2009,Oromia,East Shewa,Adami Tulu Jido Kombolcha,97,18,14,129
Megabit,7th,2011,Oromia,North Shewa,Were Jarso,95,98,21,214
Hedar,3rd,2011,Oromia,East Shewa,Lomme,38,97,39,174
Hedar,3rd,2011,Oromia,Arsi,Tiyo,86,14,80,180
Sene,10th,2009,Oromia,North Shewa,Were Jarso,46,30,27,103
Miyazia,8th,2009,Oromia,West Wellega,Gimbi Rural,10,69,37,116
Nehase,12th,2009,Oromia,West Shewa,Dano,5,52,30,87
Ginbot,9th,2010,Oromia,Finfine Zuria,Sululta Town,97,21,74,192
Hedar,3rd,2010,Oromia,West Shewa,Inchini Hospital,47,71,44,162
Yekatit,6th,2009,Oromia,West Arsi,Dodola Rural,68,41,3,112
Nehase,12th,2009,Oromia,East Wellega,Haro Limu,70,67,85,222
Nehase,12th,2010,Oromia,Horo Gudru Wellega,Horo,76,65,16,157
Sene,10th,2011,Oromia,North Shewa,Debre Libanos,37,92,91,220
Nehase,12th,2010,Oromia,Sebeta Town,Sebeta Town,5,99,90,194
Meskerem,1st,2010,Oromia,Guji,Negele Hospital,54,67,3,124
Meskerem,1st,2011,Oromia,Horo Gudru Wellega,Gudru,62,24,64,150
Miyazia,8th,2009,Oromia,Arsi,Bekoji Town,7,51,76,134
Ginbot,9th,2010,Oromia,West Guji,Bule Hora Toun,14,22,36,72
Meskerem,1st,2011,Oromia,East Shewa,Adea,21,70,83,174
Hamle,11th,2010,Oromia,West Wellega,Gimbi Rural,71,17,90,178
Megabit,7th,2010,Oromia,East Hararge,Bisidimo Hospital,16,48,4,68
Sene,10th,2009,Oromia,North Shewa,Degem,95,2,41,138
Tahesas,4th,2011,Oromia,West Shewa,Elifata,63,24,67,154
Yekatit,6th,2009,Oromia,Sululta Town,Sululta Town,11,69,84,164
Tir,5th,2009,Oromia,Ilu Aba Bora,Metu Rural,65,15,87,167
Miyazia,8th,2011,Oromia,Modjo Town,Modjo Town,65,28,96,189
Hedar,3rd,2011,Oromia,Borena,Dilo,68,53,74,195
Miyazia,8th,2011,Oromia,Arsi,Seru,44,94,26,164
Sene,10th,2009,Oromia,East Shewa,Lomme,85,24,95,204
Ginbot,9th,2009,Oromia,West Wellega,Genji,83,96,7,186
Tir,5th,2010,Oromia,Adama Special Town,Adama Town,90,51,98,239
Yekatit,6th,2010,Oromia,Sebeta Town,Sebeta Town,59,42,0,101
Meskerem,1st,2010,Oromia,West Shewa,Gedo Hospital,21,72,2,95
Tir,5th,2009,Oromia,West Guji,Hanbala,47,4,79,130
Miyazia,8th,2009,Oromia,West Arsi,Dodola Rural,19,70,46,135
Meskerem,1st,2011,Oromia,Jimma,Tiro Afeta,74,24,50,148
Hedar,3rd,2011,Oromia,Sululta Town,Sululta Town,88,28,4,120
Megabit,7th,2011,Oromia,Qeleme Wellega,Dambi Dolo Hospital,51,54,48,153
Yekatit,6th,2009,Oromia,Bale,Sinana,46,80,39,165
Hedar,3rd,2010,Oromia,East Hararge,Gursum,69,97,91,257
Yekatit,6th,2009,Oromia,Ilu Aba Bora,Ale,21,96,44,161
Ginbot,9th,2010,Oromia,East Wellega,Nunu Qumba,30,60,13,103
Sene,10th,2010,Oromia,Bale,Ginir,11,22,64,97
Ginbot,9th,2010,Oromia,West Shewa,Ejerie,57,51,69,177
Tahesas,4th,2010,Oromia,West Wellega,Yubdo,40,58,31,129
Sene,10th,2010,Oromia,Guji,Negele Town,5,10,95,110
Meskerem,1st,2010,Oromia,Guji,Saba Boru,54,49,16,119
Hedar,3rd,2011,Oromia,Horo Gudru Wellega,Amuru,9,82,23,114
Hamle,11th,2010,Oromia,East Wellega,Sibu Sire,45,87,63,195
Ginbot,9th,2011,Oromia,East Shewa,Adama,38,3,18,59
Ginbot,9th,2009,Oromia,East Shewa,Adama,59,85,31,175
Ginbot,9th,2010,Oromia,Woliso Town,Woliso Town,3,33,73,109
Tir,5th,2010,Oromia,West Shewa,Codi,97,0,49,146
Tahesas,4th,2011,Oromia,Bale,Gasera,5,67,50,122
Megabit,7th,2009,Oromia,Guji,Negele Hospital,71,11,51,133
Yekatit,6th,2011,Oromia,Sebeta Town,Sebeta Town,14,16,45,75
Tir,5th,2009,Oromia,West Hararge,Habro,87,40,42,169
Teqemt,2nd,2010,Oromia,East Wellega,Gudeyabila,98,67,9,174
Hedar,3rd,2011,Oromia,Lege Dadi Lege Tafo Town,Lege Dadi Lege Tafo Town,79,76,44,199
Tir,5th,2009,Oromia,Buno Bedele,Gechi,95,76,67,238
Teqemt,2nd,2010,Oromia,West Wellega,Genji,89,46,8,143
Meskerem,1st,2011,Oromia,Borena,El Way,92,15,26,133
Miyazia,8th,2011,Oromia,Jimma,Limu Kosa,78,29,43,150
Meskerem,1st,2010,Oromia,West Arsi,Hebal Arsi,21,18,78,117
Miyazia,8th,2010,Oromia,East Wellega,Gida Ayana,47,85,23,155
Sene,10th,2009,Oromia,Guji,Girja,24,4,40,68
Tahesas,4th,2011,Oromia,West Arsi,Gedeb Asasa,53,77,5,135
Sene,10th,2010,Oromia,Robe Town,Robe Town,53,76,74,203
Meskerem,1st,2010,Oromia,West Hararge,Guba Qoricha,55,60,47,162
Nehase,12th,2010,Oromia,Ilu Aba Bora,Ale,81,39,51,171
Miyazia,8th,2011,Oromia,West Shewa,Tibe Kutaye,90,47,67,204
Yekatit,6th,2009,Oromia,Jimma,Chora Boter,66,90,81,237
Hedar,3rd,2010,Oromia,West Shewa,Ginde Beret,33,94,81,208
Ginbot,9th,2009,Oromia,East Hararge,Kurfa Chele,25,72,88,185
Miyazia,8th,2009,Oromia,West Wellega,Yubdo,57,38,94,189
Megabit,7th,2009,Oromia,East Hararge,Haromaya Hospital,60,97,94,251
Hedar,3rd,2010,Oromia,West Shewa,Ambo Hospital,96,50,43,189
Hamle,11th,2009,Oromia,Ilu Aba Bora,Hurumu,2,62,88,152
Meskerem,1st,2010,Oromia,North Shewa,Girar Jarso,41,86,42,169
Megabit,7th,2009,Oromia,South West Shewa,Becho,51,7,80,138
Ginbot,9th,2009,Oromia,West Wellega,Guliso,53,48,10,111
Megabit,7th,2011,Oromia,Arsi,Tena,48,96,56,200
Tahesas,4th,2010,Oromia,East Wellega,Gudeyabila,44,49,81,174
Tir,5th,2011,Oromia,West Wellega,Babo Gembel,20,8,31,59
Miyazia,8th,2009,Oromia,West Wellega,Lalo Asabi,94,62,81,237
Hedar,3rd,2011,Oromia,Qeleme Wellega,Dambi Dolo Hospital,28,35,14,77
Megabit,7th,2009,Oromia,West Guji,Suro Barguda,84,83,72,239
Tahesas,4th,2010,Oromia,West Wellega,Begi Hospital,72,28,24,124
Hedar,3rd,2011,Oromia,West Wellega,Nejo Rural,76,7,46,129
Sene,10th,2010,Oromia,Arsi,Shenan Kolu,14,83,34,131
Tahesas,4th,2010,Oromia,Adama Special Town,Adama Town,79,39,88,206
Miyazia,8th,2010,Oromia,West Wellega,Guliso,60,16,10,86
Meskerem,1st,2011,Oromia,West Shewa,Elifata,86,38,93,217
Meskerem,1st,2010,Oromia,East Wellega,Kiremu,4,7,42,53
Tir,5th,2010,Oromia,East Hararge,Babile,26,38,17,81
Tahesas,4th,2011,Oromia,Horo Gudru Wellega,Amuru,71,71,40,182
Tahesas,4th,2010,Oromia,West Shewa,Metarobi,79,59,2,140
Miyazia,8th,2011,Oromia,West Arsi,Arsi Negele Town,11,71,37,119
Tir,5th,2011,Oromia,West Wellega,Jarso,67,36,65,168
Hamle,11th,2010,Oromia,West Shewa,Midakegni,20,97,44,161
Miyazia,8th,2011,Oromia,Ilu Aba Bora,Darimu,40,52,92,184
Meskerem,1st,2011,Oromia,Finfine Zuria,Berreh,64,79,32,175
Tahesas,4th,2010,Oromia,East Hararge,Goro Muti,20,63,38,121
Ginbot,9th,2011,Oromia,Gelan Town,Gelan Town,65,49,98,212
Ginbot,9th,2011,Oromia,East Wellega,Wama Hagelo,73,60,90,223
Meskerem,1st,2010,Oromia,West Wellega,Homa,69,85,46,200
Megabit,7th,2009,Oromia,West Shewa,Tikur Enchini,48,89,33,170
Ginbot,9th,2011,Oromia,North Shewa,Were Jarso,11,72,30,113
Sene,10th,2010,Oromia,West Arsi,Bishan Guracha Town,29,3,75,107
Teqemt,2nd,2011,Oromia,North Shewa,Kuyu,75,96,87,258
Miyazia,8th,2010,Oromia,Bale,Agarfa,60,31,89,180
Teqemt,2nd,2011,Oromia,Horo Gudru Wellega,Jima Rare,71,62,43,176
Teqemt,2nd,2011,Oromia,West Arsi,Siraro,72,48,27,147
Hedar,3rd,2011,Oromia,East Wellega,Jimma Arjo,33,78,53,164
Megabit,7th,2010,Oromia,West Shewa,Jibat,21,74,12,107
Miyazia,8th,2011,Oromia,West Wellega,Begi,23,19,21,63
Megabit,7th,2009,Oromia,East Hararge,Gursum,31,61,30,122
Meskerem,1st,2011,Oromia,Finfine Zuria,Akaki,38,16,51,105
Yekatit,6th,2009,Oromia,East Wellega,Nunu Qumba,28,99,59,186
Megabit,7th,2010,Oromia,West Guji,Suro Barguda,26,30,29,85
Megabit,7th,2009,Oromia,West Shewa,Ejersa Lafo,26,21,95,142
Nehase,12th,2010,Oromia,West Guji,Kercha,63,11,7,81
Yekatit,6th,2009,Oromia,West Shewa,Tibe Kutaye,4,2,66,72
Teqemt,2nd,2010,Oromia,East Hararge,Deder Town,34,59,5,98
Hamle,11th,2009,Oromia,Bale,Sinana,50,55,62,167
Megabit,7th,2011,Oromia,East Hararge,Fedis,94,53,29,176
Sene,10th,2011,Oromia,West Hararge,West Harerge	Gumbi Bordede,75,54,58,187
Megabit,7th,2011,Oromia,North Shewa,Kuyu Hospital,35,34,21,90
Ginbot,9th,2010,Oromia,Bale,Dawe Serar,72,6,85,163
Teqemt,2nd,2010,Oromia,Arsi,Sire,32,76,66,174
Meskerem,1st,2011,Oromia,Guji,Odo Shakiso,1,7,74,82
Meskerem,1st,2011,Oromia,Ilu Aba Bora,Darimu,68,56,30,154
Megabit,7th,2011,Oromia,East Wellega,Guto Gida,42,43,50,135
Hamle,11th,2009,Oromia,Ilu Aba Bora,Yayu,20,39,82,141
Megabit,7th,2011,Oromia,North Shewa,Abichugna,49,41,80,170
Teqemt,2nd,2011,Oromia,West Guji,Hanbala,89,5,28,122
Sene,10th,2010,Oromia,Shashamane Town,Shashamane Town,79,12,91,182
Tahesas,4th,2011,Oromia,Arsi,Gololcha,15,45,15,75
Teqemt,2nd,2011,Oromia,North Shewa,Aleiltu,73,29,25,127
Meskerem,1st,2010,Oromia,Ilu Aba Bora,Bure,21,73,40,134
Miyazia,8th,2010,Oromia,West Shewa,Abuna Gindeberet,22,32,19,73
Yekatit,6th,2009,Oromia,North Shewa,Dera Hospital,6,4,90,100
Yekatit,6th,2010,Oromia,Jimma,Limu Hospital,30,55,95,180
Hedar,3rd,2010,Oromia,Ilu Aba Bora,Algesachi,24,13,41,78
Meskerem,1st,2011,Oromia,West Arsi,Siraro,16,37,30,83
Sene,10th,2011,Oromia,West Arsi,Kofele,4,12,79,95
Tahesas,4th,2010,Oromia,Arsi,Aseko,14,62,56,132
Tir,5th,2010,Oromia,Ilu Aba Bora,Didu,34,81,31,146
Yekatit,6th,2010,Oromia,Buno Bedele,Chora,0,38,11,49
Sene,10th,2009,Oromia,West Hararge,Gelemso Hospital,44,57,74,175
Tir,5th,2009,Oromia,West Arsi,Dodola Rural,85,64,35,184
Tir,5th,2009,Oromia,Bishoftu Town,Bishoftu Town,81,56,8,145
Megabit,7th,2009,Oromia,Guji,Wadara,44,41,21,106
Nehase,12th,2010,Oromia,East Hararge,Midega Tole,18,53,65,136
Tahesas,4th,2010,Oromia,Borena,Moyale,94,81,98,273
Ginbot,9th,2009,Oromia,Jimma,Limu Seka,38,1,17,56
Nehase,12th,2010,Oromia,Qeleme Wellega,Laloqile,99,64,37,200
Tahesas,4th,2011,Oromia,Jimma,Agaro Hospital,72,56,15,143
Tahesas,4th,2010,Oromia,North Shewa,Girar Jarso,79,80,14,173
Miyazia,8th,2010,Oromia,South West Shewa,Ameya Hospital,65,2,46,113
Megabit,7th,2010,Oromia,Borena,El Way,90,71,12,173
Miyazia,8th,2011,Oromia,North Shewa,Kuyu Hospital,71,0,39,110
Tahesas,4th,2011,Oromia,Jimma,B/Tolyi,37,5,61,103
Tahesas,4th,2010,Oromia,Guji,Wadara,90,17,17,124
Tahesas,4th,2010,Oromia,Bale,Agarfa,22,5,17,44
Megabit,7th,2011,Oromia,Arsi,Merti,64,33,75,172
Yekatit,6th,2011,Oromia,Bale,Dawe Serar,63,23,60,146
Tahesas,4th,2010,Oromia,Buno Bedele,Dapho Hana,65,72,74,211
Miyazia,8th,2010,Oromia,Finfine Zuria,Berreh,65,78,11,154
Yekatit,6th,2011,Oromia,Horo Gudru Wellega,Jima Geneti,14,71,7,92
Ginbot,9th,2010,Oromia,West Shewa,Ambo Hospital,12,38,85,135
Megabit,7th,2011,Oromia,East Hararge,Deder Hospital,87,36,64,187
Nehase,12th,2009,Oromia,Ilu Aba Bora,Becho,55,38,2,95
Megabit,7th,2010,Oromia,Qeleme Wellega,Gidami,13,46,80,139
Megabit,7th,2009,Oromia,Jimma,Dedo,12,99,1,112
Meskerem,1st,2010,Oromia,Jimma,Mana,7,94,13,114
Miyazia,8th,2010,Oromia,Ilu Aba Bora,Algesachi,14,28,77,119
Teqemt,2nd,2011,Oromia,West Wellega,Qiltu Kara,86,65,76,227
Hedar,3rd,2010,Oromia,East Wellega,Gudeyabila,2,78,41,121
Yekatit,6th,2010,Oromia,West Hararge,Boke,61,95,72,228
Tir,5th,2011,Oromia,West Wellega,Nejo Town,40,51,11,102
Megabit,7th,2011,Oromia,Arsi,Sude,8,96,98,202
Teqemt,2nd,2010,Oromia,Qeleme Wellega,Dambi Dolo Hospital,81,77,17,175
Sene,10th,2011,Oromia,Lege Dadi Lege Tafo Town,Lege Dadi Lege Tafo Town,95,18,74,187
Ginbot,9th,2010,Oromia,Horo Gudru Wellega,Jima Rare,79,81,23,183
Teqemt,2nd,2011,Oromia,West Wellega,Gimbi Adventist Hospital,61,27,44,132
Yekatit,6th,2011,Oromia,West Shewa,Gedo Hospital,76,71,25,172
Nehase,12th,2010,Oromia,Jimma,Omonada,49,50,40,139
Meskerem,1st,2010,Oromia,West Wellega,Gimbi Adventist Hospital,33,27,72,132
Teqemt,2nd,2010,Oromia,West Hararge,Mesela,31,85,37,153
Tir,5th,2010,Oromia,Jimma,Seka Chekorsa,59,16,4,79
Megabit,7th,2010,Oromia,Guji,Aga Wayyu,25,44,80,149
Ginbot,9th,2009,Oromia,Bale,Ginir Town,67,91,10,168
Megabit,7th,2011,Oromia,East Wellega,Wama Hagelo,73,90,76,239
Megabit,7th,2009,Oromia,Bale,Sinana,60,74,18,152
Teqemt,2nd,2011,Oromia,West Arsi,Dodola Rural,3,40,51,94
Tir,5th,2011,Oromia,Jimma,Kersa,27,19,37,83
Megabit,7th,2009,Oromia,West Wellega,Babo Gembel,39,90,69,198
Sene,10th,2011,Oromia,West Hararge,Boke,56,22,65,143
Ginbot,9th,2011,Oromia,East Wellega,Haro Limu,62,9,44,115
Nehase,12th,2010,Oromia,Guji,Dima,21,28,19,68
Tir,5th,2010,Oromia,Jimma,Guma,53,73,56,182
Teqemt,2nd,2010,Oromia,Horo Gudru Wellega,Amuru,89,89,77,255
Hedar,3rd,2011,Oromia,East Hararge,Deder,7,63,14,84
Megabit,7th,2009,Oromia,Qeleme Wellega,Laloqile,49,84,90,223
Hedar,3rd,2011,Oromia,Borena,Moyale Hospital,67,76,49,192
Tahesas,4th,2010,Oromia,Bale,Gasera,25,21,95,141
Tir,5th,2011,Oromia,West Shewa,Ambo University  Hosp,35,99,54,188
Miyazia,8th,2010,Oromia,Robe Town,Robe Town,9,1,95,105
Meskerem,1st,2011,Oromia,Arsi,Zeway Dugda,59,40,29,128
Yekatit,6th,2009,Oromia,West Arsi,Dodola Rural,80,6,92,178
Tir,5th,2011,Oromia,Buno Bedele,Chora,48,13,82,143
Ginbot,9th,2009,Oromia,East Hararge,Aweday Town,91,55,5,151
Miyazia,8th,2009,Oromia,Jimma,Guma,36,15,2,53
Ginbot,9th,2009,Oromia,Bale,Legehida,9,19,84,112
Nehase,12th,2009,Oromia,West Guji,Bule Hora Toun,3,91,2,96
Miyazia,8th,2009,Oromia,East Hararge,Garemuleta Hospital,86,65,70,221
Teqemt,2nd,2010,Oromia,North Shewa,Degem,53,53,3,109
Ginbot,9th,2009,Oromia,West Guji,Biebirsa Kojowa,56,18,34,108
Megabit,7th,2009,Oromia,Bale,Delo Mena,13,73,12,98
Hedar,3rd,2011,Oromia,South West Shewa,Ameya Hospital,7,83,17,107
Sene,10th,2011,Oromia,Ambo Town,Ambo Town,83,89,42,214
Tahesas,4th,2011,Oromia,West Wellega,Homa,89,28,40,157
Hedar,3rd,2011,Oromia,Jimma,Gomma,86,81,74,241
Sene,10th,2011,Oromia,West Arsi,Loke Hada Hospital,53,50,27,130
Tahesas,4th,2010,Oromia,Guji,Odo Shakiso,99,37,12,148
Megabit,7th,2009,Oromia,East Hararge,Babile,59,40,51,150
Miyazia,8th,2011,Oromia,North Shewa,Kuyu Hospital,89,49,4,142
Ginbot,9th,2009,Oromia,East Hararge,Haromaya Rural,86,67,15,168
Hedar,3rd,2010,Oromia,East Hararge,Babile,36,82,86,204
Yekatit,6th,2009,Oromia,West Hararge,Doba,22,10,79,111
Tir,5th,2010,Oromia,Buno Bedele,Meko,55,4,80,139
Yekatit,6th,2011,Oromia,East Shewa,Dugda,77,48,36,161
Ginbot,9th,2009,Oromia,East Hararge,Bedeno,28,23,24,75
Ginbot,9th,2010,Oromia,East Hararge,Goro Gutu,12,58,76,146
Miyazia,8th,2010,Oromia,East Wellega,Sibu Sire,84,15,82,181
Ginbot,9th,2011,Oromia,West Shewa,Dano,73,55,53,181
Meskerem,1st,2010,Oromia,West Arsi,Nensebo,70,27,41,138
Tir,5th,2011,Oromia,Bale,Legehida,12,97,48,157
Megabit,7th,2011,Oromia,Horo Gudru Wellega,Amuru,3,40,69,112
Hedar,3rd,2011,Oromia,West Shewa,Tibe Kutaye,90,41,43,174
Ginbot,9th,2011,Oromia,Nekemte Town,Nekemte Town,5,5,22,32
Miyazia,8th,2010,Oromia,Jimma,Nono Benja,43,49,85,177
Teqemt,2nd,2011,Oromia,West Arsi,Bishan Guracha Town,50,76,91,217
Nehase,12th,2009,Oromia,South West Shewa,Sodo Dac'Ha,6,1,66,73
Tir,5th,2011,Oromia,East Shewa,Batu,25,97,56,178
Ginbot,9th,2011,Oromia,Jimma,Limu Hospital,54,21,11,86
Yekatit,6th,2011,Oromia,Ilu Aba Bora,Doreni,27,67,53,147
Ginbot,9th,2009,Oromia,Guji,Dima,3,30,39,72
Megabit,7th,2009,Oromia,South West Shewa,Goro,37,81,82,200
Ginbot,9th,2011,Oromia,Bale,Berbere,51,52,35,138
Tahesas,4th,2010,Oromia,East Hararge,Meta,2,77,35,114
Miyazia,8th,2011,Oromia,West Shewa,Abuna Gindeberet,23,26,30,79
Yekatit,6th,2011,Oromia,North Shewa,Kimbibit,91,82,55,228
Tir,5th,2009,Oromia,Horo Gudru Wellega,Jima Geneti,74,7,8,89
Megabit,7th,2009,Oromia,Finfine Zuria,Sandefa,6,66,62,134
Megabit,7th,2009,Oromia,West Wellega,Genji,53,94,89,236
Ginbot,9th,2009,Oromia,Borena,Yabelo Hospital,77,74,96,247
Tir,5th,2011,Oromia,East Hararge,Midega Tole,81,11,56,148
Sene,10th,2011,Oromia,Buno Bedele,Dedesa,39,24,65,128
Ginbot,9th,2011,Oromia,East Wellega,Gida Ayana,79,14,35,128
Tir,5th,2010,Oromia,South West Shewa,Goro,57,17,29,103
Miyazia,8th,2011,Oromia,East Hararge,Chelenko Hospital,99,67,7,173
Miyazia,8th,2011,Oromia,East Wellega,Haro Limu,35,9,58,102
Ginbot,9th,2009,Oromia,North Shewa,Jido,63,89,18,170
Meskerem,1st,2010,Oromia,West Wellega,Seyo Nole,24,98,68,190
Megabit,7th,2009,Oromia,Guji,Adola Town,63,54,27,144
Teqemt,2nd,2011,Oromia,West Wellega,Lalo Asabi,7,3,18,28
Miyazia,8th,2010,Oromia,Dukem Town,Dukem Town,79,35,91,205
Yekatit,6th,2009,Oromia,Jimma,Limu Kosa,72,77,62,211
Hedar,3rd,2010,Oromia,East Hararge,Gursum,74,16,61,151
Megabit,7th,2011,Oromia,West Guji,Hanbala,1,13,8,22
Nehase,12th,2010,Oromia,Guji,Aga Wayyu,44,45,33,122
Tahesas,4th,2010,Oromia,Qeleme Wellega,Hawa Gelan,69,13,47,129
Megabit,7th,2011,Oromia,Buno Bedele,Dedesa,86,6,52,144
Yekatit,6th,2010,Oromia,Qeleme Wellega,Dale Wabera,3,55,66,124
Nehase,12th,2010,Oromia,East Wellega,Boneya Bushe,43,20,96,159
Ginbot,9th,2010,Oromia,Guji,Dima,90,83,36,209
Miyazia,8th,2010,Oromia,North Shewa,Hidabu Abote,42,62,93,197
Miyazia,8th,2010,Oromia,Guji,Gumi Eldallo,17,81,72,170
Ginbot,9th,2010,Oromia,East Wellega,Ebantu,2,6,66,74
Miyazia,8th,2011,Oromia,Nekemte Town,Nekemte Town,4,94,69,167
Miyazia,8th,2011,Oromia,West Hararge,Burka Dimtu,92,17,65,174
Nehase,12th,2010,Oromia,East Hararge,Bisidimo Hospital,25,35,79,139
Yekatit,6th,2011,Oromia,West Wellega,Boji Cheqorsa,50,46,70,166
Tir,5th,2009,Oromia,Arsi,Bale Gesgara,91,77,45,213
Meskerem,1st,2010,Oromia,Borena,Yabelo Rural,53,59,76,188
Tir,5th,2010,Oromia,Qeleme Wellega,Hawa Gelan,78,32,21,131
Meskerem,1st,2010,Oromia,Bale,Robe Town,94,70,18,182
Ginbot,9th,2009,Oromia,East Hararge,Bisidimo Hospital,29,28,46,103
Megabit,7th,2010,Oromia,Jimma,Dedo,6,16,82,104
Megabit,7th,2011,Oromia,Jimma,Limu Hospital,47,19,68,134
Sene,10th,2009,Oromia,Horo Gudru Wellega,Horo,31,16,37,84
Yekatit,6th,2010,Oromia,Jimma,Limu Seka,46,37,49,132
Tir,5th,2011,Oromia,Qeleme Wellega,Kake Hosp,85,1,71,157
Hedar,3rd,2010,Oromia,North Shewa,Debre Libanos,77,27,50,154
Tahesas,4th,2011,Oromia,Horo Gudru Wellega,Abay Chomen,58,54,69,181
Megabit,7th,2009,Oromia,Burayu Town,Burayu Town,80,51,91,222
Megabit,7th,2011,Oromia,East Shewa,Adama,50,17,66,133
Ginbot,9th,2009,Oromia,West Hararge,Hawi Gudina,8,61,16,85
Hedar,3rd,2010,Oromia,East Hararge,Girawa,60,32,2,94
Teqemt,2nd,2011,Oromia,Jimma,Limu Hospital,5,28,45,78
Miyazia,8th,2011,Oromia,West Wellega,Lalo Asabi,65,20,92,177
Ginbot,9th,2010,Oromia,West Arsi,Nensebo,56,14,44,114
Yekatit,6th,2009,Oromia,South West Shewa,Wonchi,22,7,9,38
Ginbot,9th,2010,Oromia,North Shewa,Jido,28,15,21,64
Hamle,11th,2010,Oromia,West Hararge,Boke,47,76,1,124
Meskerem,1st,2011,Oromia,Jimma,Sigmo,92,54,72,218
Megabit,7th,2010,Oromia,North Shewa,Wuchale,46,27,0,73
Tahesas,4th,2011,Oromia,Bale,Ginir Town,37,76,92,205
Miyazia,8th,2010,Oromia,Guji,Adola Town,38,5,91,134
Tir,5th,2009,Oromia,Jimma Spe Town,Jimma Spe Town,71,79,58,208
Tir,5th,2009,Oromia,South West Shewa,Tole,4,17,22,43
Tir,5th,2009,Oromia,West Hararge,Daro Lebu,78,74,57,209
Tir,5th,2010,Oromia,West Arsi,Arsi Negele Rural,58,34,47,139
Ginbot,9th,2009,Oromia,Borena,Dubluk,67,19,33,119
Sene,10th,2011,Oromia,Qeleme Wellega,Hawa Gelan Hosp,84,6,81,171
Yekatit,6th,2009,Oromia,West Guji,Bule Hora Toun,20,29,62,111
Hedar,3rd,2010,Oromia,Arsi,Shenan Kolu,93,73,6,172
Yekatit,6th,2011,Oromia,Buno Bedele,Meko,71,88,31,190
Meskerem,1st,2011,Oromia,Guji,Liben,43,37,97,177
Hamle,11th,2009,Oromia,East Shewa,Mojo,41,33,14,88
Ginbot,9th,2010,Oromia,Qeleme Wellega,Dale Sedi,14,89,86,189
Nehase,12th,2010,Oromia,Jimma,Limu Seka,97,62,52,211
Miyazia,8th,2010,Oromia,West Wellega,Nole Kaba,75,71,32,178
Nehase,12th,2010,Oromia,Arsi,Zeway Dugda,41,31,58,130
Hamle,11th,2009,Oromia,North Shewa,Abichugna,72,79,53,204
Yekatit,6th,2011,Oromia,Adama Special Town,Adama Town,19,27,14,60
Megabit,7th,2009,Oromia,East Shewa,Mojo,84,76,37,197
Sene,10th,2009,Oromia,West Shewa,Ejerie,0,39,20,59
Nehase,12th,2010,Oromia,West Wellega,Gimbi Rural,43,6,38,87
Meskerem,1st,2010,Oromia,Jimma,Gomma,82,24,32,138
Miyazia,8th,2009,Oromia,West Arsi,Bishan Guracha Town,37,12,15,64
Hamle,11th,2009,Oromia,West Arsi,Dodola Rural,60,2,57,119
Hamle,11th,2009,Oromia,East Hararge,Bisidimo Hospital,18,52,50,120
Ginbot,9th,2011,Oromia,Ilu Aba Bora,Darimu,73,45,17,135
Tir,5th,2011,Oromia,Qeleme Wellega,Hawa Gelan,55,59,50,164
Miyazia,8th,2010,Oromia,North Shewa,Were Jarso,35,39,97,171
Megabit,7th,2011,Oromia,Jimma,Sekoru,91,34,28,153
Tir,5th,2011,Oromia,North Shewa,Hidabu Abote,41,92,84,217
Yekatit,6th,2011,Oromia,West Wellega,Boji Dermeji,12,6,45,63
Meskerem,1st,2010,Oromia,West Arsi,Kofele,22,82,17,121
Megabit,7th,2010,Oromia,Borena,Yabelo,36,99,92,227
Miyazia,8th,2009,Oromia,West Arsi,Bishan Guracha Town,97,70,58,225
Tir,5th,2009,Oromia,West Shewa,Ambo Town,65,10,4,79
Megabit,7th,2010,Oromia,East Shewa,Fentale,81,52,6,139
Tir,5th,2010,Oromia,West Shewa,Jeldu,87,75,79,241
Hamle,11th,2010,Oromia,West Shewa,Ambo,73,22,38,133
Tahesas,4th,2011,Oromia,Arsi,Munesa,73,9,39,121
Tir,5th,2011,Oromia,West Hararge,Gemechis,56,7,61,124
Tahesas,4th,2010,Oromia,West Shewa,Dano,39,37,26,102
Meskerem,1st,2011,Oromia,Qeleme Wellega,Hawa Gelan,26,70,48,144
Yekatit,6th,2011,Oromia,Arsi,Gololcha,36,39,18,93
Meskerem,1st,2010,Oromia,West Shewa,Gindeberet Hospital,46,91,17,154
Ginbot,9th,2009,Oromia,Jimma,Setema,71,0,4,75
Yekatit,6th,2009,Oromia,West Wellega,Gimbi,76,92,36,204
Ginbot,9th,2010,Oromia,West Guji,Biebirsa Kojowa,1,15,48,64
Nehase,12th,2010,Oromia,Arsi,Digeluna Tijo,92,38,66,196
Ginbot,9th,2009,Oromia,Bale,Meda Welabu,98,75,16,189
Nehase,12th,2010,Oromia,Ilu Aba Bora,Nono Sele,24,23,16,63
Ginbot,9th,2009,Oromia,North Shewa,Girar Jarso,24,17,34,75
Yekatit,6th,2010,Oromia,North Shewa,Girar Jarso,34,22,40,96
Sene,10th,2011,Oromia,West Wellega,Boji Dermeji,91,44,3,138
Meskerem,1st,2010,Oromia,East Hararge,Deder Hospital,26,19,1,46
Hamle,11th,2010,Oromia,Horo Gudru Wellega,Horro Buluk,31,47,93,171
Ginbot,9th,2011,Oromia,Horo Gudru Wellega,Gudru,71,82,23,176
Nehase,12th,2010,Oromia,Qeleme Wellega,Dale Sedi,49,2,56,107
Megabit,7th,2011,Oromia,West Guji,Bule Hora Toun,55,13,71,139
Ginbot,9th,2010,Oromia,West Arsi,Kokosa  Hospital,10,17,3,30
Hedar,3rd,2010,Oromia,West Shewa,Ejerie,97,75,99,271
Megabit,7th,2009,Oromia,East Hararge,Kersa Eh,27,35,8,70
Hedar,3rd,2010,Oromia,East Hararge,Kersa Eh,75,37,76,188
Tahesas,4th,2011,Oromia,Arsi,Sude,93,12,24,129
Nehase,12th,2009,Oromia,Finfine Zuria,Sululta Town,30,16,89,135
Hamle,11th,2010,Oromia,Buno Bedele,Boricha,64,96,77,237
Hamle,11th,2010,Oromia,East Hararge,Midega Tole,14,2,65,81
Miyazia,8th,2011,Oromia,East Hararge,Garemuleta Hospital,7,85,14,106
Miyazia,8th,2011,Oromia,Horo Gudru Wellega,Horro Buluk,60,15,95,170
Megabit,7th,2009,Oromia,West Shewa,Ambo,79,57,8,144
Megabit,7th,2010,Oromia,East Shewa,Matahara,5,41,36,82
Megabit,7th,2010,Oromia,Shashamane Town,Shashamane Town,11,5,90,106
Nehase,12th,2010,Oromia,West Guji,Kercha Hospital,69,90,19,178
Miyazia,8th,2011,Oromia,East Hararge,Kersa Eh,96,46,20,162
Sene,10th,2011,Oromia,West Arsi,Gambo Hospital,43,73,72,188
Sene,10th,2011,Oromia,West Shewa,Ilu Galan,31,89,42,162
Sene,10th,2009,Oromia,Lege Dadi Lege Tafo Town,Lege Dadi Lege Tafo Town,91,62,5,158
Tir,5th,2011,Oromia,East Wellega,Gobu Seyo,27,42,55,124
Ginbot,9th,2011,Oromia,Qeleme Wellega,Anfilo,96,19,15,130
Miyazia,8th,2010,Oromia,Bale,Arena Buluq,66,36,13,115
Nehase,12th,2010,Oromia,Qeleme Wellega,Dambi Dollo,85,6,5,96
Hamle,11th,2009,Oromia,Guji,Hambela Wamena,90,7,98,195
Meskerem,1st,2010,Oromia,West Wellega,Gimbi Public  Hospital,96,98,85,279
Miyazia,8th,2010,Oromia,Bale,Seweyna,7,83,2,92
Yekatit,6th,2009,Oromia,East Hararge,Haromaya Hospital,24,29,60,113
Hedar,3rd,2011,Oromia,Guji,Saba Boru,59,30,4,93
Ginbot,9th,2010,Oromia,East Hararge,Midega Tole,20,6,79,105
Tir,5th,2010,Oromia,West Shewa,Jibat,92,58,44,194
Miyazia,8th,2009,Oromia,West Shewa,Ejersa Lafo,17,38,50,105
Yekatit,6th,2009,Oromia,Jimma,Limu Hospital,94,62,96,252
Teqemt,2nd,2011,Oromia,West Shewa,Midakegni,81,6,49,136
Megabit,7th,2011,Oromia,Gelan Town,Gelan Town,80,95,46,221
Megabit,7th,2011,Oromia,Borena,Moyale Hospital,36,61,8,105
Yekatit,6th,2009,Oromia,Bale,Robe Town,99,92,83,274
Megabit,7th,2010,Oromia,South West Shewa,Tole,34,48,0,82
Miyazia,8th,2010,Oromia,South West Shewa,Dawo,17,93,83,193
Miyazia,8th,2010,Oromia,North Shewa,Wuchale,5,60,48,113
Tahesas,4th,2011,Oromia,West Arsi,Shala,47,67,12,126
Tir,5th,2009,Oromia,West Shewa,Metarobi,57,77,39,173
Tahesas,4th,2011,Oromia,Bale,Sinana,82,33,81,196
Teqemt,2nd,2010,Oromia,South West Shewa,Dawo,24,4,34,62
Miyazia,8th,2010,Oromia,West Shewa,Tikur Enchini,28,25,30,83
Hamle,11th,2009,Oromia,Arsi,Merti,34,72,82,188
Nehase,12th,2009,Oromia,Jimma,Gera,41,44,65,150
Hedar,3rd,2011,Oromia,East Hararge,Chinakesen,87,12,32,131
Tahesas,4th,2011,Oromia,East Wellega,Diga,75,99,47,221
Tir,5th,2011,Oromia,Qeleme Wellega,Dale Sedi,43,86,20,149
Sene,10th,2009,Oromia,Jimma,Mancho,96,79,1,176
Tir,5th,2011,Oromia,West Shewa,Midakegni,29,77,29,135
Yekatit,6th,2010,Oromia,Jimma,Shabe,5,13,87,105
Megabit,7th,2009,Oromia,Bale,Meda Welabu,74,11,12,97
Meskerem,1st,2011,Oromia,East Hararge,Jarso,78,92,7,177
Ginbot,9th,2009,Oromia,West Wellega,Boji Dermeji,3,45,72,120
Teqemt,2nd,2011,Oromia,Horo Gudru Wellega,Shambu Town,18,94,65,177
Tir,5th,2011,Oromia,Bale,Seweyna,9,24,48,81
Yekatit,6th,2010,Oromia,Bale,Legehida,64,49,35,148
Yekatit,6th,2011,Oromia,Buno Bedele,Bedele Town,69,7,92,168
Megabit,7th,2010,Oromia,Bale,Dawe Qachen,92,83,94,269
Miyazia,8th,2010,Oromia,Ambo Town,Ambo Town,19,39,4,62
Meskerem,1st,2011,Oromia,South West Shewa,Kersana Malima,15,49,67,131
Tahesas,4th,2011,Oromia,West Wellega,Homa,21,40,56,117
Meskerem,1st,2010,Oromia,East Shewa,Lomme,80,19,63,162
Nehase,12th,2009,Oromia,Guji,Gumi Eldallo,33,50,60,143
Ginbot,9th,2011,Oromia,Gelan Town,Gelan Town,73,8,65,146
Megabit,7th,2009,Oromia,Bale,Goba,6,87,89,182
Nehase,12th,2009,Oromia,Finfine Zuria,Sebeta Awas,97,83,82,262
Tir,5th,2011,Oromia,West Shewa,Inchini Hospital,86,40,14,140
Ginbot,9th,2009,Oromia,East Wellega,Boneya Bushe,4,50,37,91
Yekatit,6th,2009,Oromia,West Hararge,Doba,88,5,43,136
Tahesas,4th,2010,Oromia,Ilu Aba Bora,Halu,41,75,57,173
Miyazia,8th,2010,Oromia,West Wellega,Qiltu Kara,59,6,33,98
Sene,10th,2009,Oromia,West Hararge,Mesela,80,40,56,176
Sene,10th,2010,Oromia,West Wellega,Mendi Town,41,81,89,211
Megabit,7th,2011,Oromia,Jimma,B/Tolyi,68,67,25,160
Meskerem,1st,2010,Oromia,West Hararge,Oda Bultum,87,10,23,120
Miyazia,8th,2009,Oromia,West Guji,Bule Hora,98,78,33,209
Ginbot,9th,2010,Oromia,West Guji,Biebirsa Kojowa,93,23,45,161
Teqemt,2nd,2010,Oromia,West Guji,Mkelka Soda,49,27,36,112
Miyazia,8th,2010,Oromia,West Wellega,Babo Gembel,60,19,83,162
Yekatit,6th,2010,Oromia,West Arsi,Gambo Hospital,43,25,8,76
Tir,5th,2011,Oromia,Horo Gudru Wellega,Amuru,46,5,46,97
Nehase,12th,2009,Oromia,North Shewa,Degem,44,62,99,205
Nehase,12th,2009,Oromia,Arsi,Digeluna Tijo,98,20,27,145
Miyazia,8th,2011,Oromia,Finfine Zuria,Berreh,1,44,40,85
Miyazia,8th,2009,Oromia,Borena,Dilo,92,84,19,195
Megabit,7th,2009,Oromia,Ilu Aba Bora,Doreni,25,44,34,103
Sene,10th,2011,Oromia,West Shewa,Tibe Kutaye,94,9,59,162
Tahesas,4th,2011,Oromia,East Hararge,Jarso,5,94,19,118
Sene,10th,2010,Oromia,East Wellega,Gobu Seyo,68,93,44,205
Nehase,12th,2010,Oromia,Jimma,Tiro Afeta,35,83,85,203
Teqemt,2nd,2010,Oromia,West Wellega,Qiltu Kara,72,4,63,139
Megabit,7th,2009,Oromia,West Wellega,Mendi Town,52,72,64,188
Yekatit,6th,2011,Oromia,Arsi,Aseko,33,1,72,106
Tir,5th,2010,Oromia,West Wellega,Mene Sibu,43,55,4,102
Ginbot,9th,2009,Oromia,North Shewa,Yaya Gulele,34,7,28,69
Tahesas,4th,2010,Oromia,East Wellega,Haro Limu,53,26,2,81
Yekatit,6th,2010,Oromia,Jimma Spe Town,Jimma Spe Town,32,56,10,98
Nehase,12th,2010,Oromia,Ilu Aba Bora,Doreni,83,10,3,96
Ginbot,9th,2010,Oromia,West Wellega,Qiltu Kara,49,18,36,103
Ginbot,9th,2011,Oromia,Guji,Anna Sora,41,25,6,72
Tahesas,4th,2011,Oromia,West Hararge,Hawi Gudina,17,49,87,153
Sene,10th,2009,Oromia,West Hararge,Bedesa Town,67,50,51,168
Megabit,7th,2010,Oromia,North Shewa,Kuyu,94,57,82,233
Hedar,3rd,2011,Oromia,East Wellega,Diga,65,49,15,129
Ginbot,9th,2010,Oromia,West Hararge,Mesela,11,65,55,131
Teqemt,2nd,2011,Oromia,Finfine Zuria,Walmera,33,17,27,77
Miyazia,8th,2010,Oromia,Arsi,Dodota,56,12,5,73
Nehase,12th,2009,Oromia,Arsi,Jeju,33,1,92,126
Miyazia,8th,2010,Oromia,Bale,Dinsho,85,30,78,193
Meskerem,1st,2010,Oromia,West Guji,Kercha Hospital,45,92,79,216
Tir,5th,2011,Oromia,East Hararge,Garemuleta Hospital,32,19,41,92
Hedar,3rd,2010,Oromia,Horo Gudru Wellega,Hababo Guduru,79,49,62,190
Yekatit,6th,2010,Oromia,Borena,Dhas,25,12,6,43
Tir,5th,2011,Oromia,South West Shewa,Bantu  Hospital,49,64,87,200
Ginbot,9th,2011,Oromia,Arsi,Hitosa,45,3,96,144
Sene,10th,2010,Oromia,West Wellega,Nejo Hospital,7,99,14,120
Sene,10th,2011,Oromia,Arsi,Dodota,17,10,70,97
Nehase,12th,2009,Oromia,East Wellega,Gudeyabila,62,31,23,116
Nehase,12th,2009,Oromia,Bale,Gasera,65,12,61,138
Miyazia,8th,2009,Oromia,East Wellega,Sasiga,19,39,30,88
Meskerem,1st,2010,Oromia,Qeleme Wellega,Yemalogi Wolel,89,9,57,155
Nehase,12th,2009,Oromia,Ilu Aba Bora,Metu Rural,49,79,19,147
Ginbot,9th,2010,Oromia,East Hararge,Midega Tole,12,19,30,61
Tir,5th,2009,Oromia,East Wellega,Kiremu,21,85,55,161
Teqemt,2nd,2011,Oromia,Guji,Goro Dola,65,66,20,151
Sene,10th,2009,Oromia,West Hararge,Meiso,34,13,21,68
Ginbot,9th,2011,Oromia,West Shewa,Inchini Hospital,57,92,42,191
Miyazia,8th,2010,Oromia,North Shewa,Kuyu Hospital,93,17,62,172
Megabit,7th,2010,Oromia,Arsi,Sire,53,23,39,115
Megabit,7th,2010,Oromia,West Wellega,Haru,40,31,72,143
Ginbot,9th,2010,Oromia,West Wellega,Ayira,95,12,23,130
Tahesas,4th,2010,Oromia,Borena,Arero,2,55,36,93
Yekatit,6th,2010,Oromia,Guji,Bore,60,92,8,160
Meskerem,1st,2010,Oromia,West Arsi,Bishan Guracha Town,39,57,83,179
Tahesas,4th,2011,Oromia,Bale,Seweyna,72,58,6,136
Hedar,3rd,2010,Oromia,West Shewa,Ambo Hospital,52,42,82,176
Meskerem,1st,2011,Oromia,Guji,Shakiso Town,42,43,21,106
Yekatit,6th,2010,Oromia,West Wellega,Mendi Town,9,65,76,150
Nehase,12th,2009,Oromia,Jimma,B/Tolyi,44,93,20,157
Sene,10th,2010,Oromia,Borena,Arero,54,53,97,204
Hamle,11th,2009,Oromia,Arsi,Sire,65,42,2,109
Sene,10th,2011,Oromia,Arsi,Ludehetosa,96,84,32,212
Teqemt,2nd,2010,Oromia,Bale,Dawe Serar,75,43,25,143
Miyazia,8th,2011,Oromia,Guji,Shakiso Town,35,52,64,151
Ginbot,9th,2010,Oromia,Buno Bedele,Chora,49,59,99,207
Nehase,12th,2010,Oromia,West Arsi,Gedeb Asasa,38,84,34,156
Ginbot,9th,2010,Oromia,Borena,Yabelo,53,16,86,155
Yekatit,6th,2010,Oromia,Ilu Aba Bora,Metu Rural,32,21,56,109
Sene,10th,2009,Oromia,West Shewa,Tibe Kutaye,49,60,76,185
Tir,5th,2010,Oromia,South West Shewa,Kersana Malima,88,49,45,182
Miyazia,8th,2010,Oromia,Lege Dadi Lege Tafo Town,Lege Dadi Lege Tafo Town,9,57,22,88
Hedar,3rd,2010,Oromia,West Hararge,Daro Lebu,84,91,92,267
Tir,5th,2009,Oromia,Jimma,Agaro,83,9,1,93
Hedar,3rd,2010,Oromia,Guji,Wadara,85,72,29,186
Ginbot,9th,2011,Oromia,East Hararge,Deder Town,5,94,17,116
Hamle,11th,2009,Oromia,Arsi,Bale Gesgara,15,59,87,161
Meskerem,1st,2010,Oromia,Jimma Spe Town,Jimma Spe Town,81,54,85,220
Tahesas,4th,2011,Oromia,Horo Gudru Wellega,Gudru,48,6,4,58
Tir,5th,2011,Oromia,Borena,Wachile,16,48,15,79
Hedar,3rd,2011,Oromia,West Hararge,Anchar,64,28,52,144
Hamle,11th,2010,Oromia,West Wellega,Boji Dermeji,36,65,74,175
Sene,10th,2009,Oromia,West Wellega,Ayira,11,85,71,167
Tir,5th,2010,Oromia,Bale,Delo Mena,34,92,29,155
Nehase,12th,2010,Oromia,West Wellega,Haru,72,60,45,177
Hedar,3rd,2011,Oromia,Buno Bedele,Meko,61,53,65,179
Ginbot,9th,2011,Oromia,East Hararge,Chinakesen,39,3,23,65
Megabit,7th,2010,Oromia,Horo Gudru Wellega,Gudru,70,14,15,99
Hedar,3rd,2011,Oromia,Modjo Town,Modjo Town,99,16,55,170
Meskerem,1st,2011,Oromia,East Hararge,Meyu Muleke,86,92,53,231
Ginbot,9th,2009,Oromia,East Shewa,Mojo,90,75,14,179
Yekatit,6th,2009,Oromia,Qeleme Wellega,Anfilo,5,80,64,149
Ginbot,9th,2011,Oromia,West Wellega,Gimbi,57,47,8,112
Teqemt,2nd,2011,Oromia,Jimma,O/Beyam,17,6,86,109
Yekatit,6th,2011,Oromia,Arsi,Seru,85,39,39,163
Sene,10th,2009,Oromia,East Hararge,Deder Hospital,62,60,66,188
Megabit,7th,2009,Oromia,South West Shewa,Ameya,95,56,8,159
Ginbot,9th,2011,Oromia,Arsi,Jeju,64,95,30,189
Ginbot,9th,2010,Oromia,Burayu Town,Burayu Town,7,5,61,73
Nehase,12th,2010,Oromia,West Arsi,Siraro,77,25,21,123
Sene,10th,2011,Oromia,North Shewa,Jido,61,87,53,201
Nehase,12th,2009,Oromia,Qeleme Wellega,Hawa Gelan,70,86,21,177
Megabit,7th,2010,Oromia,Holeta Town,Holeta Town,89,62,79,230
Sene,10th,2010,Oromia,Ilu Aba Bora,Metu Town,13,9,2,24
Tahesas,4th,2011,Oromia,Gelan Town,Gelan Town,25,13,21,59
Tir,5th,2010,Oromia,West Arsi,Siraro,58,57,31,146
Hedar,3rd,2011,Oromia,East Shewa,Adea,0,78,42,120
Yekatit,6th,2009,Oromia,East Hararge,Girawa,54,40,26,120
Hedar,3rd,2010,Oromia,East Wellega,Leqa Dulecha,91,93,50,234
Nehase,12th,2010,Oromia,Bale,Meda Welabu,85,38,73,196
Yekatit,6th,2009,Oromia,West Hararge,Oda Bultum,25,55,95,175
Ginbot,9th,2009,Oromia,North Shewa,Dera Hospital,11,81,94,186
Miyazia,8th,2011,Oromia,East Shewa,Adama,68,3,13,84
Meskerem,1st,2010,Oromia,East Shewa,Olanciti Hospital,54,78,13,145
Sene,10th,2009,Oromia,Guji,Saba Boru,2,32,85,119
Nehase,12th,2009,Oromia,West Wellega,Ayira Hospital,46,63,7,116
Miyazia,8th,2011,Oromia,Jimma,Dedo,6,12,78,96
Megabit,7th,2010,Oromia,West Shewa,Abuna Gindeberet,9,4,18,31
Ginbot,9th,2010,Oromia,Jimma,Limu Kosa,75,47,25,147
Meskerem,1st,2011,Oromia,Qeleme Wellega,Dambi Dolo Hospital,91,11,55,157
Hedar,3rd,2010,Oromia,Horo Gudru Wellega,Gudru,49,18,3,70
Nehase,12th,2010,Oromia,West Arsi,Arsi Negele Town,76,61,80,217
Tir,5th,2010,Oromia,Borena,Dire,77,63,4,144
Tir,5th,2011,Oromia,North Shewa,Abichugna,15,92,14,121
Tir,5th,2011,Oromia,East Hararge,Bisidimo Hospital,8,17,37,62
Miyazia,8th,2010,Oromia,North Shewa,Girar Jarso,69,48,24,141
Ginbot,9th,2011,Oromia,Arsi,Limuna Bilbilo,69,93,84,246
Ginbot,9th,2009,Oromia,Buno Bedele,Meko,12,99,39,150
Nehase,12th,2009,Oromia,Arsi,Ludehetosa,68,24,70,162
Ginbot,9th,2009,Oromia,Horo Gudru Wellega,Shambu Town,58,8,34,100
Tahesas,4th,2010,Oromia,West Wellega,Begi,32,91,38,161
Hamle,11th,2009,Oromia,West Shewa,Tikur Enchini,86,48,60,194
Nehase,12th,2010,Oromia,North Shewa,Abichugna,40,67,7,114
Megabit,7th,2009,Oromia,West Shewa,Tikur Enchini,28,87,66,181
Hamle,11th,2009,Oromia,West Guji,Gelana,13,55,22,90
Meskerem,1st,2010,Oromia,West Wellega,Lalo Asabi,11,6,83,100
Teqemt,2nd,2011,Oromia,North Shewa,Debre Libanos,74,68,86,228
Tahesas,4th,2011,Oromia,North Shewa,Girar Jarso,67,68,62,197
Hedar,3rd,2010,Oromia,Finfine Zuria,Akaki,54,28,82,164
Yekatit,6th,2011,Oromia,West Wellega,Kundala,12,90,62,164
Megabit,7th,2009,Oromia,East Hararge,Jarso,20,50,26,96
Hamle,11th,2009,Oromia,Borena,Yabelo Hospital,60,11,21,92
Meskerem,1st,2011,Oromia,Woliso Town,Woliso Town,48,27,59,134
Tahesas,4th,2010,Oromia,West Shewa,Abuna Gindeberet,48,58,95,201
Tahesas,4th,2010,Oromia,West Shewa,Guder Hosp,98,27,90,215
Meskerem,1st,2011,Oromia,Ilu Aba Bora,Metu Rural,12,57,66,135
Megabit,7th,2011,Oromia,Qeleme Wellega,Kake Hosp,23,91,77,191
Sene,10th,2009,Oromia,North Shewa,Hidabu Abote,78,90,81,249
Megabit,7th,2010,Oromia,Horo Gudru Wellega,Hababo Guduru,55,19,31,105
Nehase,12th,2009,Oromia,Bale,Sinana,34,55,54,143
Meskerem,1st,2011,Oromia,West Wellega,Begi,11,9,56,76
Megabit,7th,2010,Oromia,Jimma,Sekoru,21,47,87,155
Ginbot,9th,2011,Oromia,Qeleme Wellega,Dambi Dollo,10,86,3,99
Tahesas,4th,2011,Oromia,West Guji,Suro Barguda,7,45,20,72
Tir,5th,2010,Oromia,West Wellega,Gimbi,57,60,84,201
Miyazia,8th,2009,Oromia,Finfine Zuria,Akaki,5,6,29,40
Meskerem,1st,2010,Oromia,East Hararge,Girawa,38,92,16,146
Sene,10th,2009,Oromia,North Shewa,Dera,54,88,23,165
Sene,10th,2010,Oromia,West Arsi,Dodola Rural,18,36,97,151
Megabit,7th,2011,Oromia,Guji,Gumi Eldallo,71,37,95,203
Sene,10th,2009,Oromia,East Hararge,Bedeno,80,85,65,230
Hamle,11th,2010,Oromia,West Hararge,Mesela,42,36,0,78
Ginbot,9th,2011,Oromia,West Wellega,Gimbi,58,7,85,150
Yekatit,6th,2010,Oromia,West Hararge,Bedesa Town,0,0,15,15
Meskerem,1st,2011,Oromia,Guji,Anna Sora,71,20,94,185
Miyazia,8th,2011,Oromia,Arsi,Enkelo Wabe,62,69,34,165
Ginbot,9th,2011,Oromia,Arsi,Chole,28,3,40,71
Megabit,7th,2009,Oromia,East Hararge,Gursum,14,69,56,139
Sene,10th,2009,Oromia,Bale,Delo Mena,36,3,64,103
Ginbot,9th,2011,Oromia,Qeleme Wellega,Dambi Dollo,58,49,74,181
Hamle,11th,2010,Oromia,Guji,Gumi Eldallo,67,29,22,118
Hamle,11th,2010,Oromia,South West Shewa,Woliso Rural,44,35,34,113
Hedar,3rd,2010,Oromia,West Hararge,Burka Dimtu,13,12,4,29
Hedar,3rd,2010,Oromia,West Wellega,Mendi Town,46,49,8,103
Sene,10th,2009,Oromia,West Shewa,Jibat,32,5,76,113
Tir,5th,2010,Oromia,East Wellega,Gobu Seyo,57,67,31,155
Miyazia,8th,2011,Oromia,East Wellega,Gida Ayana,47,95,26,168
Hedar,3rd,2010,Oromia,Finfine Zuria,Sululta Town,89,40,22,151
Megabit,7th,2010,Oromia,West Guji,Bule Hora Hospital,1,24,79,104
Sene,10th,2009,Oromia,Borena,Teltele,63,69,37,169
Hedar,3rd,2010,Oromia,Qeleme Wellega,Anfilo,42,30,1,73
Miyazia,8th,2010,Oromia,Bale,Ginir,68,59,52,179
Ginbot,9th,2009,Oromia,West Shewa,Liban Jawi,4,0,52,56
Ginbot,9th,2010,Oromia,Arsi,Hitosa,87,99,90,276
Hamle,11th,2009,Oromia,Bale,Ginir Town,82,37,85,204
Nehase,12th,2009,Oromia,Arsi,Robe,11,50,80,141
Nehase,12th,2010,Oromia,East Shewa,Olanciti Hospital,92,9,46,147
Sene,10th,2010,Oromia,East Shewa,Adami Tulu Jido Kombolcha,13,76,87,176
Sene,10th,2009,Oromia,Bale,Meda Welabu,23,73,21,117
Megabit,7th,2009,Oromia,East Shewa,Fentale,61,85,17,163
Megabit,7th,2011,Oromia,Horo Gudru Wellega,Horro Buluk,80,71,92,243
Nehase,12th,2010,Oromia,West Wellega,Homa,75,58,17,150
Miyazia,8th,2011,Oromia,West Arsi,Loke Hada Hospital,59,38,42,139
Tahesas,4th,2010,Oromia,West Wellega,Ayira Hospital,70,80,9,159
Ginbot,9th,2010,Oromia,East Shewa,Liben,59,16,75,150
Ginbot,9th,2010,Oromia,West Shewa,Meta Waliqite,47,33,8,88
Nehase,12th,2010,Oromia,Finfine Zuria,Sandefa,73,62,79,214
Nehase,12th,2009,Oromia,Guji,Aga Wayyu,38,31,54,123
Hamle,11th,2009,Oromia,Finfine Zuria,Sandefa,66,10,96,172
Hedar,3rd,2011,Oromia,Bale,Meda Welabu,71,61,19,151
Hamle,11th,2009,Oromia,West Shewa,Guder Hosp,15,43,3,61
Hedar,3rd,2010,Oromia,West Shewa,Gedo Hospital,64,12,97,173
Teqemt,2nd,2010,Oromia,West Wellega,Ayira,58,82,68,208
Miyazia,8th,2010,Oromia,Borena,El Way,75,29,75,179
Hamle,11th,2010,Oromia,West Hararge,Habro,7,30,43,80
Miyazia,8th,2011,Oromia,West Arsi,Loke Hada Hospital,51,43,15,109
Megabit,7th,2010,Oromia,West Arsi,Kokosa  Hospital,50,82,65,197
Nehase,12th,2010,Oromia,Jimma,O/Beyam,52,27,34,113
Sene,10th,2009,Oromia,East Shewa,Dugda,26,52,69,147
Nehase,12th,2010,Oromia,Ilu Aba Bora,Halu,81,6,10,97
Miyazia,8th,2010,Oromia,Holeta Town,Holeta Town,55,25,51,131
Hedar,3rd,2010,Oromia,Arsi,Digeluna Tijo,83,38,65,186
Ginbot,9th,2010,Oromia,East Hararge,Goro Muti,73,93,92,258
Tahesas,4th,2010,Oromia,East Shewa,Lomme,71,19,31,121
Miyazia,8th,2009,Oromia,East Wellega,Gobu Seyo,62,25,48,135
Yekatit,6th,2009,Oromia,West Guji,Biebirsa Kojowa,22,62,25,109
Hamle,11th,2010,Oromia,Jimma,Sigmo,85,82,93,260
Megabit,7th,2010,Oromia,West Wellega,Seyo Nole,77,5,5,87
Hedar,3rd,2010,Oromia,Borena,Meyo,90,50,26,166
Miyazia,8th,2011,Oromia,Jimma,Shabe,85,34,53,172
Yekatit,6th,2009,Oromia,West Guji,Bule Hora Toun,50,53,90,193
Miyazia,8th,2010,Oromia,Buno Bedele,Diga,28,10,92,130
Miyazia,8th,2010,Oromia,Guji,Hambela Wamena,49,84,71,204
Hamle,11th,2009,Oromia,East Hararge,Bedeno,89,85,57,231
Ginbot,9th,2009,Oromia,Bale,Dawe Qachen,94,75,68,237
Miyazia,8th,2009,Oromia,West Shewa,Bako Tibe,93,87,80,260
Meskerem,1st,2011,Oromia,Qeleme Wellega,Sedan Chanka,61,57,35,153
Megabit,7th,2010,Oromia,West Wellega,Gimbi Rural,99,30,10,139
Yekatit,6th,2010,Oromia,West Wellega,Nejo Rural,83,4,77,164
Miyazia,8th,2011,Oromia,North Shewa,Were Jarso,75,21,82,178
Tir,5th,2011,Oromia,West Shewa,Inchini Hospital,58,6,58,122
Sene,10th,2011,Oromia,Jimma,Limu Hospital,51,61,4,116
Megabit,7th,2011,Oromia,West Arsi,Loke Hada Hospital,75,42,46,163
Sene,10th,2010,Oromia,West Guji,Hanbala,30,38,70,138
Nehase,12th,2009,Oromia,East Wellega,Diga,76,32,48,156
Miyazia,8th,2010,Oromia,South West Shewa,Ameya Hospital,32,55,30,117
Megabit,7th,2010,Oromia,West Shewa,Ginde Beret,5,82,25,112
Ginbot,9th,2010,Oromia,Buno Bedele,Meko,59,93,28,180
Megabit,7th,2010,Oromia,Buno Bedele,Gechi,41,39,69,149
Meskerem,1st,2010,Oromia,West Hararge,Meiso,15,71,11,97
Sene,10th,2010,Oromia,West Shewa,Ambo,92,32,69,193
Tir,5th,2011,Oromia,Borena,Gomole,50,43,48,141
Hamle,11th,2009,Oromia,West Wellega,Kundala,45,19,28,92
Ginbot,9th,2009,Oromia,South West Shewa,Becho,17,26,39,82
Hedar,3rd,2011,Oromia,East Wellega,Gida Ayana,10,13,25,48
Tahesas,4th,2010,Oromia,West Arsi,Kokosa,6,59,58,123
Ginbot,9th,2011,Oromia,West Guji,Hanbala,9,47,35,91
Nehase,12th,2010,Oromia,Bale,Goro,72,43,54,169
Ginbot,9th,2010,Oromia,Buno Bedele,Bedele Hospital,90,53,1,144
Hedar,3rd,2011,Oromia,West Wellega,Homa,88,74,73,235
Yekatit,6th,2010,Oromia,South West Shewa,Ameya,87,63,84,234
Meskerem,1st,2010,Oromia,Arsi,Gololcha,68,53,61,182
Meskerem,1st,2010,Oromia,East Wellega,Ebantu,49,15,8,72
Hedar,3rd,2011,Oromia,West Hararge,Chiro Zuriya,24,22,16,62
Nehase,12th,2010,Oromia,West Wellega,Nole Kaba,52,28,87,167
Hamle,11th,2010,Oromia,East Shewa,Liben,88,92,49,229
Miyazia,8th,2011,Oromia,East Wellega,Guto Gida,4,84,60,148
Teqemt,2nd,2011,Oromia,Qeleme Wellega,Jimma Horo,54,17,66,137
Sene,10th,2010,Oromia,Qeleme Wellega,Dambi Dolo Hospital,91,1,47,139
Hamle,11th,2009,Oromia,East Hararge,Babile,60,86,17,163
Tir,5th,2009,Oromia,Arsi,Zeway Dugda,36,68,90,194
Megabit,7th,2009,Oromia,West Wellega,Mendi Hospital,32,32,77,141
Meskerem,1st,2011,Oromia,Jimma,Nono Benja,37,29,75,141
Hamle,11th,2009,Oromia,Ilu Aba Bora,Nono Sele,51,97,98,246
Teqemt,2nd,2011,Oromia,Bale,Goba,0,55,10,65
Tir,5th,2011,Oromia,West Hararge,Gelemso Hospital,52,18,76,146
Nehase,12th,2010,Oromia,East Shewa,Lomme,87,39,59,185
Miyazia,8th,2011,Oromia,Ilu Aba Bora,Algesachi,63,0,37,100
Sene,10th,2009,Oromia,Finfine Zuria,Walmera,70,34,48,152
Meskerem,1st,2011,Oromia,West Shewa,Ejerie,25,16,74,115
Meskerem,1st,2011,Oromia,West Arsi,Kofele,54,33,38,125
Yekatit,6th,2010,Oromia,East Hararge,Haromaya Hospital,23,64,99,186
Hedar,3rd,2011,Oromia,East Shewa,Batu,15,2,44,61
Ginbot,9th,2009,Oromia,Bale,Dawe Serar,34,33,4,71
Meskerem,1st,2010,Oromia,Arsi,Guna,68,4,72,144
Sene,10th,2011,Oromia,Horo Gudru Wellega,Horro Buluk,39,76,63,178
Ginbot,9th,2011,Oromia,North Shewa,Yaya Gulele,48,13,93,154
Hedar,3rd,2010,Oromia,Ilu Aba Bora,Nono Sele,84,76,42,202
Ginbot,9th,2010,Oromia,East Hararge,Kurfa Chele,14,81,95,190
Megabit,7th,2009,Oromia,East Shewa,Mojo,39,91,54,184
Tir,5th,2009,Oromia,West Arsi,Shala,12,25,37,74
Hamle,11th,2009,Oromia,Jimma,Limu Kosa,73,57,4,134
Ginbot,9th,2010,Oromia,West Shewa,Gindeberet Hospital,6,16,70,92
Ginbot,9th,2009,Oromia,North Shewa,Kimbibit,44,18,14,76
Tir,5th,2011,Oromia,Qeleme Wellega,Dambi Dolo Hospital,65,27,93,185
Hedar,3rd,2010,Oromia,Arsi,Munesa,94,39,10,143
Sene,10th,2010,Oromia,East Hararge,Bedeno,24,60,8,92
Nehase,12th,2010,Oromia,Jimma,Dedo,66,66,65,197
Tir,5th,2011,Oromia,Finfine Zuria,Sandefa,45,36,2,83
Sene,10th,2010,Oromia,West Hararge,Doba,90,60,67,217
Megabit,7th,2010,Oromia,East Shewa,Adama,72,33,76,181
Megabit,7th,2011,Oromia,West Guji,Bule Hora Hospital,55,97,31,183
Meskerem,1st,2011,Oromia,South West Shewa,Goro,48,71,38,157
Sene,10th,2010,Oromia,Guji,Anna Sora,10,44,5,59
Tahesas,4th,2011,Oromia,West Guji,Kercha Hospital,30,76,11,117
Meskerem,1st,2010,Oromia,West Hararge,Gemechis,77,54,3,134
Nehase,12th,2009,Oromia,Qeleme Wellega,Jimma Horo,39,73,99,211
Hedar,3rd,2010,Oromia,West Hararge,Meiso,56,36,2,94
Nehase,12th,2010,Oromia,Arsi,Guna,20,27,96,143
Meskerem,1st,2010,Oromia,Bale,Goba Town,83,74,15,172
Tir,5th,2010,Oromia,West Guji,Suro Barguda,83,58,31,172
Tahesas,4th,2010,Oromia,West Arsi,Gedeb Asasa,33,38,36,107
Yekatit,6th,2009,Oromia,East Shewa,Olanciti Hospital,65,51,6,122
Hedar,3rd,2011,Oromia,Horo Gudru Wellega,Horro Buluk,15,17,47,79
Ginbot,9th,2009,Oromia,West Shewa,Nono,92,21,80,193
Yekatit,6th,2011,Oromia,West Arsi,Shashemene Rural,44,21,35,100
Hamle,11th,2010,Oromia,North Shewa,Jido,38,94,17,149
Hedar,3rd,2010,Oromia,Robe Town,Robe Town,47,4,51,102
Meskerem,1st,2010,Oromia,Borena,Moyale Hospital,15,89,79,183
Hedar,3rd,2011,Oromia,West Arsi,Hebal Arsi,72,2,20,94
Meskerem,1st,2010,Oromia,Ilu Aba Bora,Algesachi,70,72,45,187
Megabit,7th,2009,Oromia,Buno Bedele,Bedele Town,28,15,37,80
Yekatit,6th,2010,Oromia,West Hararge,Meiso,28,97,20,145
Sene,10th,2010,Oromia,Buno Bedele,Bedele Town,40,88,15,143
Ginbot,9th,2009,Oromia,Arsi,Gololcha,87,12,42,141
Meskerem,1st,2010,Oromia,West Guji,Kercha,59,60,18,137
Nehase,12th,2010,Oromia,North Shewa,Jido,68,72,77,217
Meskerem,1st,2011,Oromia,Bale,Goba,24,65,63,152
Megabit,7th,2009,Oromia,West Guji,Bule Hora Toun,88,81,55,224
Teqemt,2nd,2010,Oromia,North Shewa,Kuyu Hospital,17,10,87,114
Miyazia,8th,2011,Oromia,East Hararge,Aweday Town,14,11,83,108
Hedar,3rd,2011,Oromia,East Shewa,Fentale,34,79,69,182
Miyazia,8th,2010,Oromia,Horo Gudru Wellega,Jima Rare,6,12,56,74
Miyazia,8th,2011,Oromia,West Guji,Suro Barguda,5,23,67,95
Ginbot,9th,2010,Oromia,South West Shewa,Becho,16,22,68,106
Nehase,12th,2009,Oromia,West Wellega,Lata Sibu,70,69,1,140
Ginbot,9th,2010,Oromia,East Hararge,Garemuleta Hospital,24,52,21,97
Ginbot,9th,2009,Oromia,North Shewa,Dera Hospital,97,6,77,180
Miyazia,8th,2010,Oromia,West Wellega,Mendi Town,27,65,73,165
Ginbot,9th,2010,Oromia,West Guji,Dugda Dawa,58,77,77,212
Sene,10th,2009,Oromia,Qeleme Wellega,Seyo,57,86,96,239
Nehase,12th,2009,Oromia,West Hararge,Tulo,80,14,50,144
Megabit,7th,2009,Oromia,West Guji,Dugda Dawa,68,14,97,179
Meskerem,1st,2010,Oromia,Arsi,Limuna Bilbilo,48,62,4,114
Tahesas,4th,2010,Oromia,East Hararge,Jarso,89,65,42,196
Sene,10th,2011,Oromia,North Shewa,Dera,74,40,27,141
Yekatit,6th,2009,Oromia,Bale,Goba,43,67,60,170
Ginbot,9th,2010,Oromia,East Shewa,Lomme,79,28,84,191
Nehase,12th,2010,Oromia,Horo Gudru Wellega,Jima Rare,79,99,27,205
Yekatit,6th,2009,Oromia,Horo Gudru Wellega,Jima Rare,89,74,21,184
Meskerem,1st,2010,Oromia,East Wellega,Gobu Seyo,6,62,57,125
Nehase,12th,2010,Oromia,West Hararge,Chiro Zuriya,77,56,9,142
Megabit,7th,2009,Oromia,West Wellega,Ayira,92,71,77,240
Meskerem,1st,2011,Oromia,North Shewa,Degem,12,36,37,85
Hamle,11th,2009,Oromia,Borena,Arero,50,27,29,106
Nehase,12th,2009,Oromia,West Wellega,Gimbi Public  Hospital,68,44,7,119
Megabit,7th,2009,Oromia,North Shewa,Fiche Hospital,96,69,21,186
Yekatit,6th,2009,Oromia,Jimma,Sigmo,86,45,65,196
Miyazia,8th,2010,Oromia,West Arsi,Gambo Hospital,28,69,41,138
Hamle,11th,2009,Oromia,West Guji,Abaya,15,48,57,120
Hamle,11th,2009,Oromia,Borena,Dilo,54,78,70,202
Hedar,3rd,2011,Oromia,East Hararge,Kombolicha,71,33,68,172
Meskerem,1st,2010,Oromia,Jimma,Mana,73,29,54,156
Miyazia,8th,2009,Oromia,West Wellega,Jarso,83,15,24,122
Yekatit,6th,2011,Oromia,Bale,Ginir Town,26,58,42,126
Tahesas,4th,2011,Oromia,Guji,Adola Reda,23,7,71,101
Sene,10th,2011,Oromia,Buno Bedele,Chora,92,15,24,131
Sene,10th,2009,Oromia,Bale,Legehida,1,34,19,54
Tahesas,4th,2010,Oromia,East Hararge,Gole Oda,99,4,61,164
Megabit,7th,2010,Oromia,Jimma,Seka Chekorsa,93,18,44,155
Hedar,3rd,2011,Oromia,Jimma,Limu Hospital,96,30,95,221
Yekatit,6th,2009,Oromia,West Wellega,Nejo Rural,93,60,50,203
Teqemt,2nd,2010,Oromia,East Shewa,Adami Tulu Jido Kombolcha,41,86,39,166
Miyazia,8th,2009,Oromia,Qeleme Wellega,Gawo Qebe,75,67,26,168
Teqemt,2nd,2011,Oromia,Arsi,Chole,80,92,84,256
Meskerem,1st,2010,Oromia,West Wellega,Gimbi Rural,39,87,52,178
Miyazia,8th,2011,Oromia,West Arsi,Shashemene Rural,95,73,61,229
Megabit,7th,2011,Oromia,West Shewa,Guder Hosp,12,78,31,121
Tahesas,4th,2011,Oromia,Bale,Meda Welabu,72,16,68,156
Hamle,11th,2010,Oromia,Jimma,Agaro,96,25,92,213
Hamle,11th,2010,Oromia,Jimma,Seka Chekorsa,39,97,71,207
Ginbot,9th,2011,Oromia,Borena,Moyale,30,71,28,129
Nehase,12th,2010,Oromia,Guji,Uraga,4,58,29,91
Sene,10th,2010,Oromia,Borena,El Way,53,42,84,179
Hedar,3rd,2011,Oromia,Arsi,Sude,88,36,18,142
Megabit,7th,2009,Oromia,West Hararge,West Harerge	Gumbi Bordede,13,74,10,97
Hamle,11th,2009,Oromia,North Shewa,Aleiltu,8,50,31,89
Nehase,12th,2009,Oromia,West Shewa,Tibe Kutaye,86,26,93,205
Ginbot,9th,2011,Oromia,Jimma,Sekoru,27,96,92,215
Tir,5th,2009,Oromia,Jimma,Gera,0,51,81,132
Yekatit,6th,2010,Oromia,East Hararge,Deder,81,21,14,116
Sene,10th,2011,Oromia,East Hararge,Deder Hospital,33,30,61,124
Yekatit,6th,2009,Oromia,West Hararge,Chiro Hospital,8,70,41,119
Tir,5th,2009,Oromia,East Hararge,Girawa,25,18,69,112
Miyazia,8th,2010,Oromia,Horo Gudru Wellega,Horo,68,34,76,178
Miyazia,8th,2009,Oromia,South West Shewa,Seden Sodo,81,66,74,221
Tir,5th,2010,Oromia,Arsi,Tiyo,15,30,93,138
Teqemt,2nd,2010,Oromia,East Wellega,Gobu Seyo,63,49,69,181
Tir,5th,2010,Oromia,Guji,Saba Boru,4,33,95,132
Meskerem,1st,2011,Oromia,East Hararge,Garemuleta Hospital,54,95,57,206
Ginbot,9th,2009,Oromia,Adama Special Town,Adama Town,37,52,80,169
Miyazia,8th,2011,Oromia,Jimma,Setema,80,75,66,221
Megabit,7th,2009,Oromia,West Hararge,Boke,10,57,22,89
Miyazia,8th,2010,Oromia,West Shewa,Elifata,50,63,6,119
Hedar,3rd,2010,Oromia,West Wellega,Nole Kaba,1,24,8,33
Hamle,11th,2009,Oromia,Guji,Wadara,0,81,35,116
Megabit,7th,2009,Oromia,Jimma,Mancho,76,23,66,165
Tir,5th,2011,Oromia,West Shewa,Guder Hosp,54,11,11,76
Tir,5th,2010,Oromia,West Wellega,Nole Kaba,36,7,67,110
Teqemt,2nd,2010,Oromia,West Wellega,Qiltu Kara,60,76,25,161
Ginbot,9th,2010,Oromia,East Shewa,Adea,8,31,10,49
Sene,10th,2011,Oromia,East Hararge,Kersa Eh,38,10,91,139
Ginbot,9th,2009,Oromia,West Hararge,Gelemso Hospital,96,12,77,185
Tir,5th,2010,Oromia,East Shewa,Liben,56,77,76,209
Tahesas,4th,2010,Oromia,West Guji,Bule Hora Toun,10,2,13,25
Nehase,12th,2009,Oromia,Horo Gudru Wellega,Jima Rare,10,11,0,21
Miyazia,8th,2010,Oromia,North Shewa,Aleiltu,84,59,13,156
Hamle,11th,2009,Oromia,East Hararge,Babile,11,75,96,182
Nehase,12th,2010,Oromia,Horo Gudru Wellega,Shambu Hospital,79,81,21,181
Hamle,11th,2009,Oromia,East Hararge,Bedeno,30,40,84,154
Tir,5th,2011,Oromia,East Hararge,Goro Muti,52,9,51,112
Hamle,11th,2010,Oromia,Guji,Saba Boru,31,35,67,133
Miyazia,8th,2011,Oromia,East Hararge,Deder Hospital,57,54,25,136
Hamle,11th,2010,Oromia,West Shewa,Guder Hosp,64,75,63,202
Teqemt,2nd,2011,Oromia,West Wellega,Mendi Town,48,1,86,135
Miyazia,8th,2011,Oromia,Buno Bedele,Dapho Hana,15,24,95,134
Tir,5th,2009,Oromia,East Wellega,Ebantu,92,21,75,188
Miyazia,8th,2011,Oromia,Horo Gudru Wellega,Shambu Hospital,5,24,85,114
Sene,10th,2010,Oromia,South West Shewa,Goro,11,39,75,125
Yekatit,6th,2010,Oromia,East Wellega,Wayu Tuqa,10,30,72,112
Ginbot,9th,2010,Oromia,Arsi,Ludehetosa,27,86,23,136
Nehase,12th,2009,Oromia,Arsi,Shenan Kolu,92,70,37,199
Hamle,11th,2009,Oromia,Borena,Dubluk,38,31,24,93
Teqemt,2nd,2011,Oromia,West Guji,Hanbala,85,26,93,204
Megabit,7th,2009,Oromia,Burayu Town,Burayu Town,46,32,52,130
Tahesas,4th,2011,Oromia,East Shewa,Adea,41,83,89,213
Miyazia,8th,2009,Oromia,East Hararge,Kersa Eh,51,88,80,219
Sene,10th,2009,Oromia,Bale,Legehida,44,62,47,153
Ginbot,9th,2009,Oromia,Jimma,Shabe,3,6,76,85
Meskerem,1st,2011,Oromia,Jimma,Omonada,94,60,14,168
Tahesas,4th,2011,Oromia,Jimma,Omo Nada Hospital,58,80,97,235
Megabit,7th,2010,Oromia,West Hararge,Doba,71,24,81,176
Yekatit,6th,2009,Oromia,West Wellega,Guliso,96,37,62,195
Megabit,7th,2011,Oromia,Horo Gudru Wellega,Abe Dengoro,98,23,26,147
Nehase,12th,2009,Oromia,East Hararge,Goro Gutu,30,94,29,153
Teqemt,2nd,2011,Oromia,East Wellega,Gida Ayana,24,41,13,78
Miyazia,8th,2009,Oromia,Guji,Gumi Eldallo,51,75,72,198
Teqemt,2nd,2010,Oromia,East Hararge,Babile Woreda,89,42,32,163
Miyazia,8th,2010,Oromia,Horo Gudru Wellega,Jarte Jardga,19,99,61,179
Tir,5th,2010,Oromia,Guji,Adola Town,36,16,40,92
Tahesas,4th,2011,Oromia,Guji,Dima,83,11,52,146
Tir,5th,2010,Oromia,North Shewa,Hidabu Abote,16,92,0,108
Tir,5th,2011,Oromia,Jimma,Gera,92,38,71,201
Meskerem,1st,2010,Oromia,Jimma,Sekoru,16,49,57,122
Ginbot,9th,2011,Oromia,Bishoftu Town,Bishoftu Town,33,89,81,203
Yekatit,6th,2011,Oromia,East Hararge,Kumbi,65,6,58,129
Ginbot,9th,2011,Oromia,East Hararge,Kurfa Chele,73,85,74,232
Miyazia,8th,2010,Oromia,West Guji,Bule Hora,14,15,34,63
Tir,5th,2011,Oromia,Finfine Zuria,Sandefa,55,75,90,220
Hedar,3rd,2010,Oromia,Jimma,Seka Chekorsa,0,32,94,126
Teqemt,2nd,2010,Oromia,East Wellega,Guto Gida,53,82,70,205
Hedar,3rd,2011,Oromia,West Wellega,Homa,75,27,96,198
Hamle,11th,2010,Oromia,East Wellega,Nunu Qumba,49,67,1,117
Teqemt,2nd,2011,Oromia,Holeta Town,Holeta Town,93,5,82,180
Ginbot,9th,2011,Oromia,South West Shewa,Bantu  Hospital,51,21,39,111
Miyazia,8th,2010,Oromia,West Wellega,Ayira,47,1,81,129
Megabit,7th,2009,Oromia,West Hararge,Tulo,36,20,21,77
Sene,10th,2010,Oromia,East Hararge,Chinakesen,45,62,91,198
Yekatit,6th,2010,Oromia,West Wellega,Homa,32,89,48,169
Nehase,12th,2009,Oromia,Arsi,Sire,76,64,52,192
Megabit,7th,2011,Oromia,North Shewa,Dera,7,94,55,156
Meskerem,1st,2011,Oromia,West Guji,Hanbala,73,5,37,115
Tahesas,4th,2010,Oromia,West Wellega,Boji Cheqorsa,59,33,66,158
Tahesas,4th,2010,Oromia,Shashamane Town,Shashamane Town,95,85,93,273
Hamle,11th,2010,Oromia,East Wellega,Wayu Tuqa,69,97,57,223
Yekatit,6th,2009,Oromia,West Shewa,Ilu Galan,35,63,69,167
Nehase,12th,2010,Oromia,Arsi,Jeju,29,3,86,118
Hamle,11th,2010,Oromia,West Wellega,Boji Cheqorsa,42,6,71,119
Yekatit,6th,2011,Oromia,Finfine Zuria,Berreh,53,48,94,195
Tahesas,4th,2011,Oromia,West Shewa,Codi,83,95,75,253
Ginbot,9th,2011,Oromia,Horo Gudru Wellega,Horo,23,71,39,133
Miyazia,8th,2010,Oromia,Jimma,Agaro,16,95,65,176
Hedar,3rd,2011,Oromia,East Shewa,Adami Tulu Jido Kombolcha,5,9,79,93
Miyazia,8th,2010,Oromia,Horo Gudru Wellega,Amuru,31,86,10,127
Yekatit,6th,2009,Oromia,West Guji,Mkelka Soda,73,90,14,177
Hamle,11th,2009,Oromia,West Guji,Hanbala,91,26,91,208
Yekatit,6th,2009,Oromia,Guji,Odo Shakiso,54,74,79,207
Nehase,12th,2009,Oromia,West Shewa,Elifata,56,61,17,134
Ginbot,9th,2009,Oromia,Buno Bedele,Gechi,22,50,26,98
Nehase,12th,2009,Oromia,West Wellega,Babo Gembel,99,13,70,182
Megabit,7th,2010,Oromia,West Wellega,Jarso,83,25,77,185
Tahesas,4th,2011,Oromia,East Wellega,Diga,7,24,39,70
Yekatit,6th,2010,Oromia,West Arsi,Shashemene Rural,65,46,12,123
Miyazia,8th,2009,Oromia,West Arsi,Dodola Town,85,2,49,136
Tir,5th,2011,Oromia,Bale,Seweyna,49,79,78,206
Ginbot,9th,2009,Oromia,Adama Special Town,Adama Town,93,26,18,137
Hamle,11th,2010,Oromia,Jimma,Seka Chhokorsa Hospital,98,8,76,182
Ginbot,9th,2010,Oromia,Bale,Legehida,70,77,69,216
Miyazia,8th,2011,Oromia,Ilu Aba Bora,Ale,28,12,81,121
Miyazia,8th,2011,Oromia,West Wellega,Qiltu Kara,39,30,34,103
Hedar,3rd,2011,Oromia,West Shewa,Ambo Hospital,67,89,36,192
Sene,10th,2009,Oromia,North Shewa,Kimbibit,5,73,48,126
Megabit,7th,2010,Oromia,Finfine Zuria,Berreh,32,22,47,101
Ginbot,9th,2009,Oromia,Gelan Town,Gelan Town,46,24,8,78
Megabit,7th,2011,Oromia,Ilu Aba Bora,Darimu,0,62,33,95
Yekatit,6th,2010,Oromia,Qeleme Wellega,Yemalogi Wolel,26,22,75,123
Yekatit,6th,2009,Oromia,East Hararge,Haromaya Rural,51,41,2,94
Miyazia,8th,2011,Oromia,Finfine Zuria,Sandefa,94,40,94,228
Nehase,12th,2009,Oromia,Qeleme Wellega,Anfilo,58,29,82,169
Nehase,12th,2010,Oromia,West Shewa,Ambo University  Hosp,74,40,23,137
Meskerem,1st,2010,Oromia,South West Shewa,Sodo Dac'Ha,59,3,91,153
Ginbot,9th,2011,Oromia,East Hararge,Deder Town,24,94,93,211
Teqemt,2nd,2011,Oromia,West Shewa,Jibat,58,29,56,143
Megabit,7th,2009,Oromia,Borena,Yabelo Rural,18,80,43,141
Miyazia,8th,2009,Oromia,East Shewa,Fentale,34,5,27,66
Hamle,11th,2010,Oromia,Adama Special Town,Adama Town,13,50,37,100
Tir,5th,2010,Oromia,Guji,Anna Sora,88,72,20,180
Meskerem,1st,2011,Oromia,West Arsi,Siraro,39,1,90,130
Ginbot,9th,2011,Oromia,Qeleme Wellega,Yemalogi Wolel,98,98,56,252
Nehase,12th,2009,Oromia,East Wellega,Kiremu,29,11,56,96
Tir,5th,2009,Oromia,West Guji,Mkelka Soda,88,78,84,250
Miyazia,8th,2009,Oromia,West Arsi,Nensebo,65,61,48,174
Tahesas,4th,2010,Oromia,East Hararge,Fedis,41,54,39,134
Nehase,12th,2009,Oromia,Bale,Delo Mena,36,63,30,129
Tahesas,4th,2010,Oromia,North Shewa,Dera,1,40,2,43
Tahesas,4th,2011,Oromia,Jimma,Gomma,66,2,18,86
Megabit,7th,2009,Oromia,Bale,Robe Town,56,37,29,122
Megabit,7th,2010,Oromia,Adama Special Town,Adama Town,8,24,5,37
Hedar,3rd,2011,Oromia,Bale,Meda Welabu,90,72,23,185
Teqemt,2nd,2010,Oromia,Borena,Yabelo Rural,15,72,30,117
Tir,5th,2011,Oromia,South West Shewa,Woliso Rural,48,49,93,190
Miyazia,8th,2011,Oromia,Qeleme Wellega,Dambi Dolo Hospital,40,49,59,148
Sene,10th,2010,Oromia,Ilu Aba Bora,Algesachi,92,41,55,188
Hamle,11th,2010,Oromia,South West Shewa,Tulu Bolo Hospital,12,9,79,100
Yekatit,6th,2010,Oromia,West Hararge,Mesela,95,67,97,259
Ginbot,9th,2009,Oromia,Borena,Dilo,76,52,38,166
Megabit,7th,2011,Oromia,Arsi,Hitosa,91,53,4,148
Hamle,11th,2010,Oromia,West Guji,Bule Hora Hospital,3,15,59,77
Tir,5th,2010,Oromia,West Shewa,Inchini Hospital,34,70,53,157
Yekatit,6th,2009,Oromia,Sululta Town,Sululta Town,64,76,11,151
Hamle,11th,2009,Oromia,South West Shewa,Tole,49,81,15,145
Nehase,12th,2009,Oromia,West Shewa,Ambo,94,22,79,195
Yekatit,6th,2011,Oromia,Qeleme Wellega,Dambi Dollo,36,86,47,169
Sene,10th,2011,Oromia,East Wellega,Limu,79,94,93,266
Teqemt,2nd,2011,Oromia,West Arsi,Kofele,67,56,39,162
Miyazia,8th,2010,Oromia,West Wellega,Seyo Nole,61,54,45,160
Hedar,3rd,2010,Oromia,Borena,Moyale Hospital,33,80,28,141
Ginbot,9th,2010,Oromia,Qeleme Wellega,Dambi Dollo,91,68,68,227
Ginbot,9th,2011,Oromia,East Wellega,Kiremu,73,93,26,192
Megabit,7th,2011,Oromia,West Wellega,Haru,53,85,6,144
Yekatit,6th,2010,Oromia,Jimma,Sigmo,21,60,95,176
Yekatit,6th,2009,Oromia,West Arsi,Kokosa,95,83,90,268
Sene,10th,2009,Oromia,Bale,Goba,9,31,76,116
Sene,10th,2009,Oromia,West Guji,Bule Hora Hospital,74,59,48,181
Hedar,3rd,2010,Oromia,Finfine Zuria,Berreh,77,46,81,204
Yekatit,6th,2011,Oromia,West Shewa,Codi,72,94,59,225
Miyazia,8th,2010,Oromia,Guji,Anna Sora,44,52,25,121
Ginbot,9th,2010,Oromia,Guji,Girja,78,96,76,250
Nehase,12th,2010,Oromia,West Wellega,Kundala,44,44,51,139
Tahesas,4th,2010,Oromia,West Arsi,Dodola Rural,55,1,93,149
Hedar,3rd,2011,Oromia,West Guji,Bule Hora Hospital,42,76,84,202
Hedar,3rd,2010,Oromia,Borena,Moyale,64,91,71,226
Ginbot,9th,2010,Oromia,North Shewa,Aleiltu,9,74,81,164
Miyazia,8th,2010,Oromia,South West Shewa,Ilu,42,71,57,170
Sene,10th,2010,Oromia,Guji,Adola Town,97,80,93,270
Megabit,7th,2010,Oromia,Ilu Aba Bora,Metu Rural,93,31,82,206
Sene,10th,2009,Oromia,Bale,Dawe Serar,5,53,93,151
Tir,5th,2011,Oromia,Jimma,B/Tolyi,9,5,18,32
Yekatit,6th,2010,Oromia,West Wellega,Haru,87,18,69,174
Megabit,7th,2009,Oromia,Borena,Yabelo Rural,72,27,17,116
Tir,5th,2010,Oromia,South West Shewa,Tole,45,75,8,128
Ginbot,9th,2011,Oromia,Horo Gudru Wellega,Shambu Hospital,60,44,49,153
Sene,10th,2009,Oromia,Bale,Ginir Town,56,56,45,157
Miyazia,8th,2011,Oromia,Bale,Goro,14,30,38,82
Megabit,7th,2011,Oromia,Arsi,Shirka,1,16,8,25
Tir,5th,2009,Oromia,Ilu Aba Bora,Ale,86,5,16,107
Ginbot,9th,2010,Oromia,East Wellega,Wayu Tuqa,83,21,60,164
Teqemt,2nd,2010,Oromia,Buno Bedele,Boricha,90,46,28,164
Megabit,7th,2010,Oromia,North Shewa,Aleiltu,17,46,92,155
Nehase,12th,2010,Oromia,Qeleme Wellega,Gidami,55,14,86,155
Tir,5th,2011,Oromia,East Hararge,Kombolicha,93,38,96,227
Ginbot,9th,2010,Oromia,Guji,Odo Shakiso,28,0,43,71
Hedar,3rd,2010,Oromia,North Shewa,Kuyu,95,89,99,283
Yekatit,6th,2010,Oromia,East Hararge,Chinakesen,16,89,27,132
Hedar,3rd,2010,Oromia,Arsi,Jeju,92,77,18,187
Hamle,11th,2009,Oromia,East Shewa,Adami Tulu Jido Kombolcha,36,9,38,83
Hamle,11th,2010,Oromia,Jimma,Dedo,99,9,19,127
Miyazia,8th,2011,Oromia,Buno Bedele,Dedesa,67,72,25,164
Yekatit,6th,2011,Oromia,Borena,Wachile,31,26,46,103
Miyazia,8th,2009,Oromia,West Arsi,Nensebo,84,82,81,247
Ginbot,9th,2011,Oromia,South West Shewa,Becho,28,98,15,141
Ginbot,9th,2009,Oromia,Borena,Dire,28,69,23,120
Hedar,3rd,2010,Oromia,West Wellega,Ayira Hospital,35,40,74,149
Meskerem,1st,2010,Oromia,North Shewa,Hidabu Abote,39,81,9,129
Nehase,12th,2010,Oromia,Guji,Adola Town,32,92,80,204
Hamle,11th,2010,Oromia,Bale,Seweyna,58,60,55,173
Ginbot,9th,2011,Oromia,Arsi,Tiyo,10,1,39,50
Hedar,3rd,2011,Oromia,Guji,Girja,94,53,15,162
Ginbot,9th,2009,Oromia,East Hararge,Chelenko Hospital,92,20,9,121
Tahesas,4th,2010,Oromia,West Shewa,Metarobi,54,73,79,206
Ginbot,9th,2010,Oromia,Bale,Sinana,13,12,43,68
Yekatit,6th,2010,Oromia,Bale,Ginir,5,15,90,110
Sene,10th,2009,Oromia,Arsi,Tiyo,81,26,87,194
Hedar,3rd,2010,Oromia,West Hararge,Mesela,25,60,11,96
Tir,5th,2010,Oromia,Horo Gudru Wellega,Jima Geneti,29,93,92,214
Nehase,12th,2010,Oromia,West Wellega,Gimbi Adventist Hospital,72,34,5,111
Hamle,11th,2009,Oromia,Arsi,Amigna,55,39,6,100
Ginbot,9th,2010,Oromia,West Wellega,Mendi Town,44,31,98,173
Megabit,7th,2010,Oromia,West Hararge,Burka Dimtu,19,85,33,137
Sene,10th,2009,Oromia,West Arsi,Arsi Negele Rural,79,69,46,194
Sene,10th,2011,Oromia,Jimma,O/Beyam,41,95,3,139
Nehase,12th,2010,Oromia,West Arsi,Dodola Town,60,19,36,115
Teqemt,2nd,2011,Oromia,Arsi,Tiyo,94,36,46,176
Tahesas,4th,2010,Oromia,East Wellega,Leqa Dulecha,9,19,20,48
Tahesas,4th,2011,Oromia,East Hararge,Chinakesen,53,23,44,120
Miyazia,8th,2011,Oromia,North Shewa,Jido,62,60,50,172
Meskerem,1st,2011,Oromia,East Hararge,Deder,34,94,24,152
Sene,10th,2010,Oromia,West Hararge,Chiro Hospital,9,12,15,36
Sene,10th,2010,Oromia,Ilu Aba Bora,Yayu,68,52,37,157
Yekatit,6th,2009,Oromia,East Wellega,Wama Hagelo,68,64,42,174
Hamle,11th,2009,Oromia,East Shewa,Matahara,30,37,78,145
Ginbot,9th,2011,Oromia,West Hararge,Burka Dimtu,25,5,30,60
Nehase,12th,2009,Oromia,West Wellega,Gimbi,61,93,83,237
Yekatit,6th,2009,Oromia,Shashamane Town,Shashamane Town,67,82,14,163
Meskerem,1st,2010,Oromia,West Hararge,Meiso,4,26,21,51
Hedar,3rd,2010,Oromia,South West Shewa,Tulu Bolo Hospital,35,80,93,208
Teqemt,2nd,2010,Oromia,East Hararge,Girawa,75,8,3,86
Hamle,11th,2009,Oromia,Borena,Guchi,53,63,91,207
Megabit,7th,2011,Oromia,East Hararge,Kombolicha,55,68,35,158
Miyazia,8th,2011,Oromia,Horo Gudru Wellega,Abe Dengoro,97,64,82,243
Megabit,7th,2010,Oromia,East Shewa,Fentale,54,61,8,123
Miyazia,8th,2011,Oromia,Buno Bedele,Chewaqa,35,54,25,114
Sene,10th,2011,Oromia,West Wellega,Ayira Hospital,56,13,85,154
Megabit,7th,2010,Oromia,Finfine Zuria,Sululta Town,89,62,80,231
Miyazia,8th,2011,Oromia,West Shewa,Jibat,80,27,20,127
Teqemt,2nd,2010,Oromia,West Shewa,Abuna Gindeberet,5,8,3,16
Yekatit,6th,2010,Oromia,East Shewa,Olanciti Hospital,82,27,99,208
Ginbot,9th,2010,Oromia,Guji,Adola Hospital,23,27,18,68
Miyazia,8th,2010,Oromia,West Hararge,Chiro Town,86,27,10,123
Sene,10th,2011,Oromia,West Wellega,Lalo Asabi,86,81,66,233
Nehase,12th,2009,Oromia,Arsi,Gololcha,20,89,21,130
Ginbot,9th,2009,Oromia,East Wellega,Nunu Qumba,79,21,16,116
Hedar,3rd,2010,Oromia,Arsi,Tiyo,21,38,67,126
Meskerem,1st,2011,Oromia,Arsi,Enkelo Wabe,54,74,31,159
Hedar,3rd,2011,Oromia,Shashamane Town,Shashamane Town,10,84,46,140
Miyazia,8th,2011,Oromia,South West Shewa,Ameya,97,10,67,174
Megabit,7th,2010,Oromia,North Shewa,Abichugna,18,22,63,103
Tir,5th,2010,Oromia,East Wellega,Guto Gida,4,58,84,146
Sene,10th,2010,Oromia,Buno Bedele,Chora,17,35,35,87
Ginbot,9th,2009,Oromia,West Shewa,Inchini Hospital,90,34,74,198
Ginbot,9th,2010,Oromia,West Wellega,Nejo Rural,44,22,33,99
Megabit,7th,2010,Oromia,Jimma,Seka Chekorsa,6,16,82,104
Tir,5th,2010,Oromia,Borena,Dubluk,38,30,91,159
Sene,10th,2009,Oromia,Borena,Dire,28,40,34,102
Ginbot,9th,2011,Oromia,West Guji,Bule Hora Toun,61,74,44,179
Tir,5th,2011,Oromia,East Wellega,Wayu Tuqa,60,63,83,206
Nehase,12th,2010,Oromia,West Shewa,Ambo Hospital,47,58,91,196
Miyazia,8th,2011,Oromia,East Wellega,Wama Hagelo,95,86,27,208
Ginbot,9th,2010,Oromia,Ilu Aba Bora,Becho,82,10,43,135
Megabit,7th,2009,Oromia,Borena,Yabelo Hospital,35,1,55,91
Hamle,11th,2009,Oromia,Guji,Adola Reda,70,71,15,156
Yekatit,6th,2009,Oromia,East Hararge,Midega Tole,16,54,62,132
Yekatit,6th,2010,Oromia,East Shewa,Adama,66,42,65,173
Tir,5th,2011,Oromia,Ilu Aba Bora,Ale,12,94,48,154
Hamle,11th,2009,Oromia,East Hararge,Garemuleta Hospital,68,50,40,158
Teqemt,2nd,2010,Oromia,West Wellega,Haru,45,17,88,150
Meskerem,1st,2010,Oromia,East Hararge,Bisidimo Hospital,94,34,5,133
Miyazia,8th,2010,Oromia,West Wellega,Guliso,31,78,78,187
Tahesas,4th,2011,Oromia,East Hararge,Deder Hospital,77,82,29,188
Ginbot,9th,2010,Oromia,Arsi,Robe,16,9,22,47
Tir,5th,2011,Oromia,Guji,Adola Reda,58,6,86,150
Sene,10th,2009,Oromia,Jimma,Agaro,27,13,65,105
Meskerem,1st,2010,Oromia,West Hararge,Oda Bultum,29,75,20,124
Megabit,7th,2010,Oromia,West Wellega,Yubdo,1,8,44,53
Ginbot,9th,2010,Oromia,Arsi,Shirka,33,46,63,142
Ginbot,9th,2009,Oromia,Borena,Gomole,93,10,88,191
Sene,10th,2009,Oromia,Horo Gudru Wellega,Jima Geneti,27,75,79,181
Megabit,7th,2010,Oromia,West Hararge,Habro,77,63,74,214
Miyazia,8th,2011,Oromia,West Wellega,Mene Sibu,17,7,25,49
Tir,5th,2011,Oromia,Buno Bedele,Boricha,38,53,15,106
Tir,5th,2011,Oromia,Arsi,Merti,32,42,3,77
Megabit,7th,2010,Oromia,Arsi,Tiyo,97,48,65,210
Meskerem,1st,2011,Oromia,East Wellega,Nunu Qumba,22,46,42,110
Yekatit,6th,2010,Oromia,West Wellega,Begi,27,73,81,181
Ginbot,9th,2010,Oromia,Finfine Zuria,Berreh,15,71,2,88
Miyazia,8th,2009,Oromia,Borena,Yabelo Hospital,90,22,49,161
Hamle,11th,2009,Oromia,Buno Bedele,Meko,73,63,27,163
Sene,10th,2010,Oromia,East Wellega,Guto Gida,6,83,27,116
Sene,10th,2010,Oromia,South West Shewa,Ameya,43,40,48,131
Megabit,7th,2010,Oromia,Horo Gudru Wellega,Shambu Town,26,12,52,90
Ginbot,9th,2011,Oromia,Buno Bedele,Dapho Hana,54,96,18,168
Miyazia,8th,2010,Oromia,West Wellega,Begi Hospital,89,45,18,152
Hedar,3rd,2010,Oromia,East Wellega,Gudeyabila,9,60,23,92
Ginbot,9th,2010,Oromia,Lege Dadi Lege Tafo Town,Lege Dadi Lege Tafo Town,92,23,47,162
Hedar,3rd,2011,Oromia,Arsi,Jeju,77,2,24,103
Miyazia,8th,2010,Oromia,East Wellega,Ebantu,28,46,60,134
Tahesas,4th,2010,Oromia,West Wellega,Haru,58,91,54,203
Meskerem,1st,2010,Oromia,East Hararge,Kombolicha,80,52,39,171
Miyazia,8th,2010,Oromia,West Hararge,Daro Lebu,21,17,70,108
Yekatit,6th,2009,Oromia,Guji,Adola Reda,44,67,11,122
Megabit,7th,2010,Oromia,Bale,Ginir,95,91,94,280
Hamle,11th,2009,Oromia,East Hararge,Meyu Muleke,89,11,29,129
Nehase,12th,2009,Oromia,Arsi,Robe,42,5,31,78
Hedar,3rd,2011,Oromia,Jimma,Tiro Afeta,40,20,90,150
Hedar,3rd,2010,Oromia,West Shewa,Dendi,21,48,33,102
Nehase,12th,2009,Oromia,Ilu Aba Bora,Darimu,76,83,47,206
Nehase,12th,2010,Oromia,Guji,Hambela Wamena,60,93,11,164
Miyazia,8th,2011,Oromia,Jimma,O/Beyam,66,61,63,190
Miyazia,8th,2010,Oromia,Arsi,Chole,32,92,85,209
Tir,5th,2010,Oromia,Arsi,Shirka,93,15,50,158
Megabit,7th,2010,Oromia,West Guji,Bule Hora,81,2,57,140
Ginbot,9th,2011,Oromia,Jimma,Mana,44,86,96,226
Megabit,7th,2011,Oromia,Guji,Negele Hospital,45,33,81,159
Teqemt,2nd,2011,Oromia,East Wellega,Boneya Bushe,9,76,88,173
Ginbot,9th,2009,Oromia,Arsi,Zeway Dugda,49,89,62,200
Megabit,7th,2011,Oromia,Woliso Town,Woliso Town,90,35,8,133
Ginbot,9th,2009,Oromia,South West Shewa,Kersana Malima,19,20,87,126
Miyazia,8th,2010,Oromia,Arsi,Hitosa,73,69,91,233
Yekatit,6th,2011,Oromia,West Guji,Bule Hora Toun,70,0,56,126
Hedar,3rd,2010,Oromia,West Shewa,Ejerie,1,61,73,135
Hamle,11th,2010,Oromia,West Arsi,Wondo,53,71,51,175
Nehase,12th,2010,Oromia,Bale,Arena Buluq,62,30,66,158
Ginbot,9th,2011,Oromia,Borena,Guchi,93,37,51,181
Hedar,3rd,2011,Oromia,North Shewa,Aleiltu,39,98,79,216
Miyazia,8th,2009,Oromia,Guji,Negele Hospital,45,30,50,125
Hamle,11th,2010,Oromia,West Wellega,Boji Cheqorsa,10,79,33,122
Miyazia,8th,2009,Oromia,West Wellega,Lata Sibu,43,77,47,167
Ginbot,9th,2010,Oromia,Guji,Odo Shakiso,84,87,13,184
Hedar,3rd,2010,Oromia,West Shewa,Elifata,90,43,15,148
Hedar,3rd,2011,Oromia,Jimma,Nono Benja,57,56,72,185
Miyazia,8th,2011,Oromia,West Wellega,Guliso,9,71,48,128
Meskerem,1st,2010,Oromia,East Wellega,Nunu Qumba,35,36,73,144
Megabit,7th,2009,Oromia,Guji,Odo Shakiso,6,57,14,77
Teqemt,2nd,2010,Oromia,Horo Gudru Wellega,Shambu Town,77,78,24,179
Meskerem,1st,2010,Oromia,West Hararge,Mesela,97,0,47,144
Nehase,12th,2010,Oromia,East Hararge,Babile Woreda,87,55,16,158
Megabit,7th,2011,Oromia,West Wellega,Boji Cheqorsa,78,76,75,229
Hamle,11th,2010,Oromia,Lege Dadi Lege Tafo Town,Lege Dadi Lege Tafo Town,9,49,71,129
Miyazia,8th,2009,Oromia,Arsi,Zeway Dugda,68,6,55,129
Meskerem,1st,2011,Oromia,Borena,Arero,10,26,93,129
Yekatit,6th,2011,Oromia,North Shewa,Debre Libanos,25,68,32,125
Yekatit,6th,2010,Oromia,South West Shewa,Seden Sodo,31,58,65,154
Hamle,11th,2010,Oromia,Bale,Dawe Serar,45,48,60,153
Tahesas,4th,2011,Oromia,East Hararge,Haromaya Town,37,75,36,148
Hamle,11th,2010,Oromia,West Wellega,Genji,64,3,69,136
Miyazia,8th,2010,Oromia,Jimma,Mana,74,52,75,201
Tir,5th,2009,Oromia,Ilu Aba Bora,Yayu,9,17,7,33
Ginbot,9th,2010,Oromia,Guji,Gumi Eldallo,32,1,68,101
Sene,10th,2009,Oromia,East Hararge,Haromaya Town,55,52,10,117
Nehase,12th,2010,Oromia,Bale,Gololcha,52,88,65,205
Megabit,7th,2010,Oromia,West Shewa,Jibat,38,48,84,170
Hamle,11th,2009,Oromia,East Wellega,Ebantu,43,40,42,125
Miyazia,8th,2010,Oromia,Jimma,Gomma,39,40,92,171
Hedar,3rd,2011,Oromia,Jimma,Gomma,99,20,18,137
Meskerem,1st,2010,Oromia,South West Shewa,Dawo,65,32,43,140
Miyazia,8th,2011,Oromia,Bale,Arena Buluq,97,70,25,192
Meskerem,1st,2011,Oromia,West Wellega,Gimbi Adventist Hospital,43,66,39,148
Nehase,12th,2010,Oromia,East Hararge,Melka Belo,84,94,29,207
Ginbot,9th,2009,Oromia,West Guji,Hanbala,22,83,17,122
Ginbot,9th,2010,Oromia,West Shewa,Codi,0,22,74,96
Teqemt,2nd,2011,Oromia,Guji,Saba Boru,67,82,66,215
Sene,10th,2010,Oromia,Horo Gudru Wellega,Abe Dengoro,0,0,44,44
Ginbot,9th,2009,Oromia,East Hararge,Babile Woreda,24,15,71,110
Tir,5th,2009,Oromia,West Wellega,Begi,9,57,89,155
Ginbot,9th,2009,Oromia,West Guji,Bule Hora Toun,10,56,9,75
Tir,5th,2009,Oromia,Guji,Liben,53,53,80,186
Yekatit,6th,2010,Oromia,Jimma,Tiro Afeta,78,95,91,264
Meskerem,1st,2011,Oromia,West Arsi,Loke Hada Hospital,75,80,75,230
Teqemt,2nd,2010,Oromia,Arsi,Seru,17,83,0,100
Nehase,12th,2010,Oromia,Arsi,Hitosa,48,50,42,140
Nehase,12th,2010,Oromia,East Shewa,Adea,13,88,51,152
Megabit,7th,2009,Oromia,West Wellega,Ayira,96,67,90,253
Teqemt,2nd,2010,Oromia,Horo Gudru Wellega,Amuru,5,15,88,108
Nehase,12th,2009,Oromia,West Arsi,Shala,25,5,36,66
Hedar,3rd,2010,Oromia,Gelan Town,Gelan Town,90,10,23,123
Hedar,3rd,2011,Oromia,Guji,Odo Shakiso,27,95,71,193
Megabit,7th,2010,Oromia,West Shewa,Gindeberet Hospital,43,99,68,210
Nehase,12th,2010,Oromia,Buno Bedele,Dedesa,13,1,81,95
Nehase,12th,2010,Oromia,Arsi,Hitosa,83,90,21,194
Tir,5th,2011,Oromia,West Wellega,Gimbi Public  Hospital,11,66,71,148
Ginbot,9th,2009,Oromia,Bale,Dawe Qachen,56,72,85,213
Yekatit,6th,2009,Oromia,Buno Bedele,Chora,90,36,17,143
Miyazia,8th,2009,Oromia,Guji,Aga Wayyu,97,2,9,108
Megabit,7th,2009,Oromia,Ilu Aba Bora,Metu Rural,12,79,76,167
Ginbot,9th,2010,Oromia,Qeleme Wellega,Hawa Gelan,85,76,45,206
Tir,5th,2011,Oromia,West Guji,Dugda Dawa,4,73,53,130
Hedar,3rd,2010,Oromia,Jimma,Dedo,79,43,12,134
Hedar,3rd,2011,Oromia,West Wellega,Boji Cheqorsa,83,6,8,97
Sene,10th,2010,Oromia,Qeleme Wellega,Seyo,0,1,66,67
Miyazia,8th,2010,Oromia,Bishoftu Town,Bishoftu Town,0,62,35,97
Hamle,11th,2009,Oromia,East Hararge,Girawa,29,32,78,139
Teqemt,2nd,2010,Oromia,Guji,Adola Hospital,27,10,40,77
Nehase,12th,2010,Oromia,Arsi,Chole,46,21,40,107
Megabit,7th,2010,Oromia,Qeleme Wellega,Sedan Chanka,36,33,41,110
Yekatit,6th,2010,Oromia,East Hararge,Goro Muti,18,67,32,117
Sene,10th,2010,Oromia,West Guji,Abaya,99,92,54,245
Ginbot,9th,2009,Oromia,Qeleme Wellega,Laloqile,59,61,33,153
Ginbot,9th,2009,Oromia,Horo Gudru Wellega,Abay Chomen,64,35,89,188
Sene,10th,2010,Oromia,Horo Gudru Wellega,Abay Chomen,60,8,24,92
Nehase,12th,2009,Oromia,East Hararge,Chelenko Hospital,30,96,24,150
Teqemt,2nd,2010,Oromia,West Shewa,Gojo Hospital,24,32,87,143
Yekatit,6th,2010,Oromia,North Shewa,Yaya Gulele,28,66,54,148
Ginbot,9th,2010,Oromia,Horo Gudru Wellega,Shambu Hospital,65,99,16,180
Meskerem,1st,2010,Oromia,West Wellega,Qiltu Kara,12,33,44,89
Meskerem,1st,2010,Oromia,Horo Gudru Wellega,Horo,75,24,96,195
Hamle,11th,2009,Oromia,West Hararge,Oda Bultum,96,11,67,174
Ginbot,9th,2010,Oromia,West Shewa,Dano,99,57,37,193
Teqemt,2nd,2010,Oromia,Arsi,Limuna Bilbilo,41,96,4,141
Hamle,11th,2010,Oromia,East Shewa,Fentale,94,44,75,213
Tir,5th,2011,Oromia,West Wellega,Ayira Hospital,58,94,59,211
Meskerem,1st,2010,Oromia,Horo Gudru Wellega,Abay Chomen,31,31,45,107
Megabit,7th,2011,Oromia,West Guji,Gelana,13,60,97,170
Miyazia,8th,2011,Oromia,East Wellega,Ebantu,47,2,89,138
Miyazia,8th,2010,Oromia,West Wellega,Ayira,7,4,5,16
Tir,5th,2009,Oromia,Guji,Gumi Eldallo,91,45,51,187
Tir,5th,2011,Oromia,Borena,Yabelo Hospital,11,74,6,91
Meskerem,1st,2010,Oromia,East Wellega,Wayu Tuqa,52,21,16,89
Sene,10th,2011,Oromia,Qeleme Wellega,Seyo,16,31,56,103
Hedar,3rd,2011,Oromia,West Shewa,Dano,13,84,78,175
Yekatit,6th,2010,Oromia,West Hararge,Chiro Hospital,90,94,93,277
Ginbot,9th,2009,Oromia,Arsi,Dodota,39,20,2,61
Tahesas,4th,2010,Oromia,North Shewa,Hidabu Abote,10,34,58,102
Ginbot,9th,2011,Oromia,West Guji,Abaya,5,76,67,148
Miyazia,8th,2010,Oromia,West Shewa,Ejersa Lafo,48,27,78,153
Ginbot,9th,2010,Oromia,Jimma,Kersa,2,57,28,87
Meskerem,1st,2011,Oromia,North Shewa,Dera,53,57,38,148
Megabit,7th,2010,Oromia,Finfine Zuria,Mullo,53,51,80,184
Ginbot,9th,2009,Oromia,Guji,Adola Town,12,4,73,89
Miyazia,8th,2010,Oromia,Bale,Ginir,51,79,41,171
Yekatit,6th,2010,Oromia,North Shewa,Jido,60,67,40,167
Miyazia,8th,2011,Oromia,Arsi,Aseko,56,25,68,149
Megabit,7th,2009,Oromia,Finfine Zuria,Mullo,84,29,85,198
Ginbot,9th,2011,Oromia,West Guji,Hanbala,81,60,87,228
Miyazia,8th,2011,Oromia,West Guji,Bule Hora,43,87,4,134
Meskerem,1st,2011,Oromia,Jimma Spe Town,Jimma Spe Town,26,48,1,75
Nehase,12th,2009,Oromia,West Shewa,Ilu Galan,24,59,38,121
Nehase,12th,2010,Oromia,Arsi,Robe,41,5,36,82
Yekatit,6th,2009,Oromia,West Wellega,Gimbi Rural,26,78,53,157
Meskerem,1st,2010,Oromia,East Hararge,Midega Tole,55,23,2,80
Megabit,7th,2009,Oromia,Arsi,Guna,6,64,56,126
Ginbot,9th,2009,Oromia,Jimma Spe Town,Jimma Spe Town,22,96,1,119
Nehase,12th,2010,Oromia,Guji,Wadara,60,75,39,174
Yekatit,6th,2009,Oromia,Borena,Yabelo Rural,3,92,79,174
Yekatit,6th,2009,Oromia,West Wellega,Nejo Town,59,33,80,172
Ginbot,9th,2010,Oromia,West Shewa,Guder Hosp,73,91,64,228
Tir,5th,2010,Oromia,South West Shewa,St.Luke Hospital,38,22,55,115
Ginbot,9th,2011,Oromia,Ambo Town,Ambo Town,30,30,69,129
Hedar,3rd,2011,Oromia,West Wellega,Ayira Hospital,78,78,78,234
Sene,10th,2010,Oromia,Guji,Negele Hospital,66,67,72,205
Miyazia,8th,2009,Oromia,West Guji,Dugda Dawa,26,70,6,102
Sene,10th,2009,Oromia,Bale,Ginir,65,87,95,247
Ginbot,9th,2011,Oromia,West Wellega,Mene Sibu,69,10,66,145
Megabit,7th,2010,Oromia,West Hararge,Boke,52,32,26,110
Sene,10th,2010,Oromia,Dukem Town,Dukem Town,36,10,3,49
Meskerem,1st,2010,Oromia,East Shewa,Dugda,72,96,55,223
Miyazia,8th,2009,Oromia,East Hararge,Melka Belo,81,55,2,138
Ginbot,9th,2009,Oromia,Bale,Delo Mena,10,69,75,154
Ginbot,9th,2009,Oromia,Guji,Adola Hospital,92,70,52,214
Tir,5th,2009,Oromia,Arsi,Amigna,10,71,62,143
Megabit,7th,2009,Oromia,West Shewa,Bako Tibe,31,88,0,119
Miyazia,8th,2009,Oromia,Sululta Town,Sululta Town,37,88,35,160
Nehase,12th,2009,Oromia,East Wellega,Leqa Dulecha,67,75,21,163
Tahesas,4th,2010,Oromia,West Arsi,Shashemene Rural,23,56,98,177
Sene,10th,2009,Oromia,East Hararge,Babile,75,56,68,199
Hamle,11th,2009,Oromia,East Wellega,Gida Ayana,2,50,64,116
Megabit,7th,2009,Oromia,Ilu Aba Bora,Yayu,74,71,49,194
Hamle,11th,2010,Oromia,Buno Bedele,Bedele Hospital,76,19,49,144
Hedar,3rd,2010,Oromia,West Arsi,Arsi Negele Rural,89,2,5,96
Sene,10th,2011,Oromia,Borena,Yabelo Rural,0,92,3,95
Ginbot,9th,2009,Oromia,Horo Gudru Wellega,Hababo Guduru,80,56,35,171
Sene,10th,2011,Oromia,West Guji,Dugda Dawa,2,54,5,61
Meskerem,1st,2011,Oromia,Arsi,Bale Gesgara,33,30,27,90
Megabit,7th,2009,Oromia,Assela Town,Assela Town,66,20,91,177
Teqemt,2nd,2011,Oromia,West Shewa,Ginde Beret,83,44,91,218
Ginbot,9th,2010,Oromia,Horo Gudru Wellega,Chomen Guduru,31,74,4,109
Tahesas,4th,2010,Oromia,Dukem Town,Dukem Town,59,12,66,137
Sene,10th,2009,Oromia,West Arsi,Nensebo,42,23,99,164
Sene,10th,2010,Oromia,East Hararge,Kersa Eh,48,23,69,140
Ginbot,9th,2009,Oromia,Arsi,Munesa,73,15,5,93
Ginbot,9th,2011,Oromia,West Shewa,Adea Berga,36,53,28,117
Tahesas,4th,2010,Oromia,Bale,Goba,55,38,5,98
Ginbot,9th,2011,Oromia,West Wellega,Guliso,87,93,65,245
Miyazia,8th,2010,Oromia,East Hararge,Kombolicha,89,44,42,175
Miyazia,8th,2010,Oromia,Ilu Aba Bora,Halu,81,38,62,181
Miyazia,8th,2009,Oromia,East Shewa,Fentale,10,27,56,93
Sene,10th,2011,Oromia,Bale,Dinsho,95,7,54,156
Ginbot,9th,2010,Oromia,West Shewa,Ejersa Lafo,31,11,3,45
Meskerem,1st,2011,Oromia,Guji,Hambela Wamena,72,96,17,185
Meskerem,1st,2011,Oromia,West Shewa,Gedo Hospital,97,95,10,202
Sene,10th,2011,Oromia,West Hararge,Gemechis,5,15,95,115
Sene,10th,2011,Oromia,West Guji,Dugda Dawa,61,14,91,166
Hedar,3rd,2011,Oromia,East Wellega,Leqa Dulecha,28,79,55,162
Megabit,7th,2010,Oromia,Finfine Zuria,Berreh,30,97,24,151
Megabit,7th,2010,Oromia,Arsi,Sude,6,57,39,102
Miyazia,8th,2011,Oromia,West Wellega,Qiltu Kara,25,73,78,176
Hedar,3rd,2011,Oromia,North Shewa,Fichetown,98,58,83,239
Yekatit,6th,2009,Oromia,Assela Town,Assela Town,95,59,64,218
Ginbot,9th,2009,Oromia,West Wellega,Gimbi,8,29,50,87
Tahesas,4th,2010,Oromia,Finfine Zuria,Sebeta Awas,78,17,67,162
Miyazia,8th,2009,Oromia,Finfine Zuria,Holeta,98,84,62,244
Hamle,11th,2010,Oromia,Arsi,Ludehetosa,12,30,95,137
Hamle,11th,2009,Oromia,West Shewa,Ejersa Lafo,88,53,35,176
Sene,10th,2011,Oromia,Borena,Yabelo Hospital,3,86,77,166
Megabit,7th,2009,Oromia,Guji,Adola Reda,2,2,89,93
Yekatit,6th,2010,Oromia,West Arsi,Siraro,26,60,91,177
Miyazia,8th,2009,Oromia,East Hararge,Babile Woreda,97,78,26,201
Miyazia,8th,2010,Oromia,West Wellega,Genji,97,91,28,216
Megabit,7th,2010,Oromia,Arsi,Merti,49,70,18,137
Ginbot,9th,2011,Oromia,West Arsi,Kokosa,93,11,94,198
Megabit,7th,2009,Oromia,Guji,Negele Hospital,77,19,54,150
Miyazia,8th,2011,Oromia,Guji,Hambela Wamena,77,71,80,228
Hedar,3rd,2011,Oromia,Horo Gudru Wellega,Jima Rare,13,98,42,153
Miyazia,8th,2011,Oromia,Qeleme Wellega,Dambi Dollo,71,53,41,165
Megabit,7th,2011,Oromia,Horo Gudru Wellega,Shambu Town,15,69,25,109
Teqemt,2nd,2011,Oromia,West Hararge,Guba Qoricha,57,85,95,237
Tir,5th,2011,Oromia,North Shewa,Hidabu Abote,41,34,92,167
Tir,5th,2011,Oromia,Qeleme Wellega,Sedan Chanka,96,58,87,241
Miyazia,8th,2010,Oromia,West Wellega,Mendi Town,40,38,50,128
Ginbot,9th,2011,Oromia,Horo Gudru Wellega,Chomen Guduru,6,86,4,96
Ginbot,9th,2011,Oromia,West Shewa,Dendi,82,29,11,122
Megabit,7th,2009,Oromia,East Wellega,Sibu Sire,1,37,90,128
Tir,5th,2010,Oromia,Jimma,O/Beyam,52,22,11,85
Hedar,3rd,2011,Oromia,Jimma,Guma,26,14,57,97
Tahesas,4th,2010,Oromia,Arsi,Seru,11,18,46,75
Megabit,7th,2009,Oromia,Arsi,Guna,34,17,18,69
Megabit,7th,2010,Oromia,Ilu Aba Bora,Hurumu,38,52,29,119
Sene,10th,2009,Oromia,North Shewa,Kimbibit,88,95,39,222
Hamle,11th,2009,Oromia,Dukem Town,Dukem Town,73,23,97,193
Hedar,3rd,2011,Oromia,South West Shewa,Woliso Rural,1,63,31,95
Yekatit,6th,2010,Oromia,South West Shewa,Wonchi,74,70,45,189
Ginbot,9th,2010,Oromia,Bale,Ginir Town,8,83,75,166
Megabit,7th,2011,Oromia,Buno Bedele,Gechi,12,67,80,159
Ginbot,9th,2009,Oromia,West Wellega,Lalo Asabi,97,77,9,183
Tahesas,4th,2011,Oromia,West Wellega,Seyo Nole,88,8,76,172
Tahesas,4th,2010,Oromia,East Hararge,Haromaya Town,46,53,76,175
Sene,10th,2011,Oromia,West Shewa,Codi,66,70,25,161
Hamle,11th,2010,Oromia,Arsi,Sude,73,31,31,135
Hedar,3rd,2011,Oromia,East Hararge,Midega Tole,57,63,46,166
Meskerem,1st,2011,Oromia,West Shewa,Midakegni,67,90,94,251
Hamle,11th,2009,Oromia,Borena,Moyale,50,29,7,86
Sene,10th,2010,Oromia,Bale,Seweyna,43,9,57,109
Hamle,11th,2009,Oromia,Borena,Yabelo,78,83,65,226
Ginbot,9th,2011,Oromia,West Wellega,Nole Kaba,98,91,84,273
Yekatit,6th,2009,Oromia,Jimma,Gera,27,26,83,136
Meskerem,1st,2011,Oromia,Adama Special Town,Adama Town,70,49,50,169
Hedar,3rd,2010,Oromia,Qeleme Wellega,Sedan Chanka,17,51,46,114
Nehase,12th,2010,Oromia,Arsi,Jeju,75,10,92,177
Meskerem,1st,2010,Oromia,Bale,Dawe Serar,31,81,22,134
Meskerem,1st,2010,Oromia,West Shewa,Ambo Hospital,16,68,73,157
Miyazia,8th,2010,Oromia,Arsi,Robe,94,5,83,182
Sene,10th,2011,Oromia,East Hararge,Fedis,60,82,5,147
Teqemt,2nd,2010,Oromia,North Shewa,Dera,92,9,18,119
Meskerem,1st,2010,Oromia,West Shewa,Liban Jawi,51,8,43,102
Miyazia,8th,2010,Oromia,West Guji,Bule Hora,26,12,22,60
Miyazia,8th,2009,Oromia,Arsi,Jeju,3,41,53,97
Nehase,12th,2010,Oromia,Bale,Gasera,8,19,62,89
Yekatit,6th,2009,Oromia,Jimma,Agaro,84,32,41,157
Miyazia,8th,2010,Oromia,Finfine Zuria,Mullo,85,70,38,193
Miyazia,8th,2009,Oromia,Arsi,Hitosa,76,16,17,109
Sene,10th,2011,Oromia,North Shewa,Girar Jarso,89,71,57,217
Meskerem,1st,2011,Oromia,Qeleme Wellega,Sedan Chanka,83,38,10,131
Sene,10th,2010,Oromia,North Shewa,Aleiltu,99,90,58,247
Miyazia,8th,2011,Oromia,East Wellega,Haro Limu,87,65,49,201
Teqemt,2nd,2011,Oromia,East Wellega,Wama Hagelo,86,29,9,124
Hedar,3rd,2011,Oromia,East Hararge,Meta,32,43,74,149
Tir,5th,2011,Oromia,Lege Dadi Lege Tafo Town,Lege Dadi Lege Tafo Town,98,81,12,191
Nehase,12th,2010,Oromia,West Arsi,Siraro,34,67,14,115
Tir,5th,2010,Oromia,West Shewa,Ginde Beret,54,88,61,203
Tir,5th,2010,Oromia,Bale,Legehida,37,55,58,150
Ginbot,9th,2010,Oromia,Bale,Goba,83,72,35,190
Megabit,7th,2009,Oromia,Arsi,Jeju,16,61,34,111
Hedar,3rd,2010,Oromia,Finfine Zuria,Akaki,12,32,33,77
Ginbot,9th,2010,Oromia,Holeta Town,Holeta Town,35,64,27,126
Nehase,12th,2010,Oromia,East Hararge,Melka Belo,37,79,76,192
Yekatit,6th,2011,Oromia,Qeleme Wellega,Gidami,19,26,51,96
Megabit,7th,2011,Oromia,West Shewa,Adea Berga,7,99,7,113
Megabit,7th,2009,Oromia,West Hararge,Chiro Zuriya,60,9,16,85
Nehase,12th,2010,Oromia,West Shewa,Abuna Gindeberet,91,68,5,164
Hedar,3rd,2010,Oromia,Lege Dadi Lege Tafo Town,Lege Dadi Lege Tafo Town,70,92,45,207
Hedar,3rd,2010,Oromia,Bishoftu Town,Bishoftu Town,25,83,41,149
Hamle,11th,2010,Oromia,Horo Gudru Wellega,Abe Dengoro,17,84,79,180
Miyazia,8th,2011,Oromia,East Hararge,Garemuleta Hospital,67,22,83,172
Miyazia,8th,2009,Oromia,West Hararge,Habro,81,10,72,163
Nehase,12th,2009,Oromia,Adama Special Town,Adama Town,21,85,20,126
Ginbot,9th,2011,Oromia,West Wellega,Nejo Rural,85,18,38,141
Ginbot,9th,2010,Oromia,Qeleme Wellega,Sedan Chanka,64,16,84,164
Meskerem,1st,2010,Oromia,South West Shewa,Woliso Rural,81,89,62,232
Tir,5th,2011,Oromia,West Shewa,Dano,89,7,31,127
Tahesas,4th,2011,Oromia,West Wellega,Mendi Town,75,7,36,118
Tir,5th,2011,Oromia,Ambo Town,Ambo Town,24,95,81,200
Ginbot,9th,2010,Oromia,West Wellega,Gimbi,29,20,82,131
Sene,10th,2011,Oromia,Qeleme Wellega,Anfilo,51,5,60,116
Ginbot,9th,2010,Oromia,North Shewa,Hidabu Abote,8,58,68,134
Sene,10th,2010,Oromia,East Wellega,Diga,68,45,96,209
Sene,10th,2010,Oromia,East Hararge,Deder Town,69,80,96,245
Tir,5th,2010,Oromia,Guji,Adola Reda,0,80,66,146
Sene,10th,2009,Oromia,East Shewa,Batu,94,45,56,195
Ginbot,9th,2010,Oromia,West Guji,Kercha Hospital,29,89,43,161
Tir,5th,2009,Oromia,Horo Gudru Wellega,Amuru,98,25,92,215
Tahesas,4th,2011,Oromia,East Hararge,Haromaya Rural,63,3,9,75
Tahesas,4th,2011,Oromia,Borena,El Way,76,34,25,135
Miyazia,8th,2011,Oromia,Qeleme Wellega,Laloqile,74,35,67,176
Tahesas,4th,2010,Oromia,Buno Bedele,Dedesa,35,25,44,104
Tir,5th,2010,Oromia,Dukem Town,Dukem Town,15,1,41,57
Miyazia,8th,2009,Oromia,West Wellega,Nejo Rural,39,28,69,136
Megabit,7th,2010,Oromia,West Hararge,Oda Bultum,9,52,50,111
Hamle,11th,2009,Oromia,East Wellega,Leqa Dulecha,95,84,65,244
Yekatit,6th,2011,Oromia,Qeleme Wellega,Dale Wabera,14,97,92,203
Nehase,12th,2009,Oromia,Sululta Town,Sululta Town,90,8,52,150
Miyazia,8th,2010,Oromia,Guji,Saba Boru,55,28,67,150
Tahesas,4th,2010,Oromia,Qeleme Wellega,Dambi Dolo Hospital,59,27,41,127
Megabit,7th,2010,Oromia,Qeleme Wellega,Dambi Dollo,82,0,84,166
Miyazia,8th,2011,Oromia,West Arsi,Gambo Hospital,86,90,60,236
Hamle,11th,2009,Oromia,West Guji,Suro Barguda,92,95,77,264
Hamle,11th,2009,Oromia,West Hararge,Mesela,18,42,23,83
Hamle,11th,2010,Oromia,Borena,Dhas,38,39,71,148
Teqemt,2nd,2011,Oromia,Borena,Meyo,77,37,36,150
Teqemt,2nd,2011,Oromia,West Wellega,Mendi Hospital,58,84,47,189
Nehase,12th,2009,Oromia,East Wellega,Boneya Bushe,87,20,29,136
Meskerem,1st,2011,Oromia,West Hararge,Boke,64,14,19,97
Sene,10th,2011,Oromia,North Shewa,Dera,10,25,82,117
Sene,10th,2010,Oromia,Jimma,O/Beyam,78,38,43,159
Yekatit,6th,2011,Oromia,West Wellega,Genji,26,69,63,158
Tahesas,4th,2010,Oromia,East Wellega,Sasiga,31,70,74,175
Megabit,7th,2009,Oromia,West Shewa,Ejersa Lafo,43,21,99,163
Sene,10th,2011,Oromia,West Guji,Bule Hora,47,50,33,130
Ginbot,9th,2009,Oromia,North Shewa,Were Jarso,88,8,75,171
Teqemt,2nd,2010,Oromia,West Arsi,Dodola Town,33,62,23,118
Sene,10th,2010,Oromia,Bale,Goro,54,39,55,148
Miyazia,8th,2010,Oromia,Arsi,Deksis,98,89,80,267
Tir,5th,2009,Oromia,Qeleme Wellega,Dambi Dollo,20,82,87,189
Tir,5th,2011,Oromia,West Shewa,Codi,17,24,76,117
Yekatit,6th,2011,Oromia,West Arsi,Shala,62,36,9,107
Nehase,12th,2010,Oromia,Buno Bedele,Chewaqa,11,23,22,56
Tahesas,4th,2011,Oromia,West Wellega,Gimbi Rural,79,79,61,219
Miyazia,8th,2011,Oromia,West Guji,Dugda Dawa,55,34,21,110
Nehase,12th,2010,Oromia,West Wellega,Kundala,22,39,84,145
Yekatit,6th,2009,Oromia,West Shewa,Jeldu,86,37,77,200
Hedar,3rd,2011,Oromia,West Shewa,Abuna Gindeberet,20,11,61,92
Hamle,11th,2009,Oromia,Jimma,Setema,91,54,60,205
Ginbot,9th,2010,Oromia,West Hararge,Mesela,48,58,6,112
Tahesas,4th,2011,Oromia,Ilu Aba Bora,Nono Sele,41,31,79,151
Miyazia,8th,2011,Oromia,Buno Bedele,Gechi,63,68,93,224
Miyazia,8th,2011,Oromia,Bale,Raitu,6,12,72,90
Sene,10th,2009,Oromia,East Wellega,Ebantu,47,18,89,154
Megabit,7th,2010,Oromia,Arsi,Amigna,93,23,57,173
Ginbot,9th,2011,Oromia,West Arsi,Loke Hada Hospital,89,93,62,244
Sene,10th,2011,Oromia,West Wellega,Nejo Rural,64,35,78,177
Hedar,3rd,2010,Oromia,Jimma,Omonada,91,75,95,261
Megabit,7th,2009,Oromia,Ilu Aba Bora,Ale,2,56,3,61
Tir,5th,2010,Oromia,West Shewa,Gindeberet Hospital,2,26,69,97
Hedar,3rd,2011,Oromia,West Guji,Biebirsa Kojowa,54,22,43,119
Hedar,3rd,2011,Oromia,West Arsi,Dodola Town,72,89,94,255
Meskerem,1st,2011,Oromia,Buno Bedele,Boricha,32,7,88,127
Nehase,12th,2010,Oromia,Horo Gudru Wellega,Amuru,14,93,97,204
Ginbot,9th,2011,Oromia,Arsi,Seru,94,34,76,204
Megabit,7th,2011,Oromia,East Wellega,Boneya Bushe,93,96,63,252
Miyazia,8th,2010,Oromia,West Wellega,Haru,22,63,33,118
Nehase,12th,2009,Oromia,Borena,Dhas,77,71,10,158
Miyazia,8th,2009,Oromia,West Arsi,Dodola Rural,12,66,3,81
Hamle,11th,2010,Oromia,Finfine Zuria,Sululta Town,28,98,80,206
Tahesas,4th,2010,Oromia,Jimma Spe Town,Jimma Spe Town,23,62,12,97
Tir,5th,2009,Oromia,East Shewa,Mojo,96,89,80,265
Tir,5th,2011,Oromia,West Shewa,Bako Tibe,79,90,12,181
Teqemt,2nd,2010,Oromia,West Hararge,Meiso,25,85,29,139
Hamle,11th,2009,Oromia,West Shewa,Midakegni,92,64,90,246
Tir,5th,2009,Oromia,Horo Gudru Wellega,Abay Chomen,67,80,61,208
Tir,5th,2011,Oromia,Guji,Bore Hospital,14,49,13,76
Ginbot,9th,2010,Oromia,North Shewa,Kuyu,16,38,45,99
Meskerem,1st,2010,Oromia,Bale,Goba Town,34,1,50,85
Tir,5th,2011,Oromia,West Wellega,Kundala,22,90,12,124
Hedar,3rd,2010,Oromia,North Shewa,Dera Hospital,2,69,33,104
Tir,5th,2009,Oromia,Arsi,Munesa,35,25,61,121
Tir,5th,2011,Oromia,West Wellega,Guliso,8,34,37,79
Megabit,7th,2011,Oromia,Ilu Aba Bora,Bure,36,63,1,100
Sene,10th,2009,Oromia,Bale,Legehida,70,7,9,86
Ginbot,9th,2010,Oromia,East Hararge,Bedeno,19,92,61,172
Megabit,7th,2010,Oromia,Jimma,Shabe,28,39,41,108
Hedar,3rd,2011,Oromia,Borena,El Way,46,62,69,177
Tir,5th,2009,Oromia,West Hararge,Doba,72,30,94,196
Megabit,7th,2010,Oromia,West Wellega,Nejo Hospital,30,23,53,106
Ginbot,9th,2011,Oromia,Qeleme Wellega,Dale Wabera,99,4,78,181
Meskerem,1st,2010,Oromia,East Hararge,Kumbi,47,94,97,238
Tir,5th,2010,Oromia,Arsi,Aseko,98,42,11,151
Tahesas,4th,2010,Oromia,West Hararge,Boke,35,77,32,144
Nehase,12th,2009,Oromia,Ilu Aba Bora,Halu,34,18,70,122
Tahesas,4th,2011,Oromia,Arsi,Deksis,93,93,97,283
Ginbot,9th,2009,Oromia,Qeleme Wellega,Gidami,21,20,16,57
Nehase,12th,2009,Oromia,West Arsi,Nensebo,2,62,93,157
Yekatit,6th,2011,Oromia,West Wellega,Nole Kaba,5,41,50,96
Miyazia,8th,2011,Oromia,Ilu Aba Bora,Darimu,18,96,6,120
Ginbot,9th,2011,Oromia,West Wellega,Haru,67,95,24,186
Tir,5th,2011,Oromia,West Wellega,Mene Sibu,70,25,13,108
Sene,10th,2011,Oromia,Ilu Aba Bora,Hurumu,10,27,62,99
Tahesas,4th,2010,Oromia,West Hararge,Hawi Gudina,63,0,81,144
Hamle,11th,2009,Oromia,Arsi,Munesa,49,11,61,121
Nehase,12th,2010,Oromia,Horo Gudru Wellega,Abay Chomen,91,15,10,116
Tir,5th,2011,Oromia,Buno Bedele,Boricha,38,2,13,53
Miyazia,8th,2009,Oromia,West Shewa,Inchini Hospital,97,70,56,223
Nehase,12th,2009,Oromia,Buno Bedele,Meko,48,2,34,84
Yekatit,6th,2011,Oromia,West Shewa,Bako Hospital,60,88,44,192
Meskerem,1st,2010,Oromia,Guji,Goro Dola,82,68,16,166
Sene,10th,2009,Oromia,Arsi,Hitosa,39,71,93,203
Miyazia,8th,2009,Oromia,Horo Gudru Wellega,Jima Rare,39,48,46,133
Megabit,7th,2009,Oromia,Borena,Dubluk,21,92,35,148
Nehase,12th,2009,Oromia,West Wellega,Nole Kaba,35,59,5,99
Ginbot,9th,2010,Oromia,West Wellega,Jarso,44,15,76,135
Meskerem,1st,2011,Oromia,West Arsi,Gedeb Asasa,44,33,45,122
Tir,5th,2011,Oromia,Ilu Aba Bora,Hurumu,24,28,27,79
Megabit,7th,2010,Oromia,West Shewa,Meta Waliqite,45,63,18,126
Tahesas,4th,2010,Oromia,West Wellega,Guliso,73,92,80,245
Yekatit,6th,2011,Oromia,Ilu Aba Bora,Bure,63,86,12,161
Miyazia,8th,2011,Oromia,East Hararge,Gursum,19,40,15,74
Teqemt,2nd,2010,Oromia,Bale,Gasera,95,27,47,169
Ginbot,9th,2009,Oromia,West Wellega,Begi,57,26,21,104
Teqemt,2nd,2011,Oromia,West Arsi,Kore,90,2,86,178
Tir,5th,2011,Oromia,West Arsi,Loke Hada Hospital,22,54,57,133
Tahesas,4th,2010,Oromia,Ilu Aba Bora,Becho,52,87,96,235
Megabit,7th,2011,Oromia,East Wellega,Diga,61,14,80,155
Tir,5th,2009,Oromia,Jimma,Limu Seka,88,78,52,218
Megabit,7th,2009,Oromia,East Shewa,Dugda,38,33,69,140
Sene,10th,2011,Oromia,East Hararge,Babile Woreda,54,28,12,94
Miyazia,8th,2011,Oromia,Horo Gudru Wellega,Jarte Jardga,35,3,69,107
Tir,5th,2011,Oromia,Borena,Gomole,14,71,4,89
Tir,5th,2009,Oromia,West Arsi,Dodola Town,92,98,79,269
Sene,10th,2009,Oromia,West Arsi,Bishan Guracha Town,46,54,15,115
Meskerem,1st,2011,Oromia,West Guji,Kercha,52,30,38,120
Miyazia,8th,2009,Oromia,East Hararge,Chinakesen,50,60,61,171
Miyazia,8th,2010,Oromia,West Wellega,Nole Kaba,13,54,31,98
Ginbot,9th,2009,Oromia,Jimma,Sekoru,61,91,4,156
Megabit,7th,2010,Oromia,East Hararge,Babile,16,79,56,151
Megabit,7th,2010,Oromia,West Shewa,Ginde Beret,41,93,39,173
Megabit,7th,2009,Oromia,East Hararge,Chinakesen,48,21,58,127
Hamle,11th,2010,Oromia,West Wellega,Yubdo,41,1,69,111
Ginbot,9th,2010,Oromia,West Shewa,Liban Jawi,92,9,30,131
Yekatit,6th,2010,Oromia,East Hararge,Meyu Muleke,21,86,62,169
Megabit,7th,2011,Oromia,Guji,Adola Reda,80,7,0,87
Miyazia,8th,2010,Oromia,West Wellega,Mendi Hospital,80,3,79,162
Yekatit,6th,2009,Oromia,North Shewa,Yaya Gulele,89,50,21,160
Ginbot,9th,2011,Oromia,Bale,Legehida,46,18,97,161
Hamle,11th,2010,Oromia,Buno Bedele,Diga,66,3,81,150
Megabit,7th,2009,Oromia,Bale,Dawe Serar,9,18,20,47
Miyazia,8th,2011,Oromia,Arsi,Guna,2,22,9,33
Tir,5th,2011,Oromia,West Guji,Abaya,1,52,22,75
Megabit,7th,2009,Oromia,West Wellega,Genji,56,89,8,153
Yekatit,6th,2009,Oromia,East Hararge,Deder,0,55,3,58
Teqemt,2nd,2011,Oromia,East Wellega,Leqa Dulecha,69,28,82,179
Megabit,7th,2010,Oromia,West Wellega,Gimbi Rural,86,5,38,129
Miyazia,8th,2011,Oromia,Borena,Dubluk,2,7,45,54
Yekatit,6th,2010,Oromia,Buno Bedele,Bedele Zuriya,44,56,73,173
Tahesas,4th,2010,Oromia,West Wellega,Gimbi,93,94,28,215
Ginbot,9th,2011,Oromia,Jimma,O/Beyam,42,42,3,87
Megabit,7th,2010,Oromia,West Arsi,Kokosa,79,62,42,183
Miyazia,8th,2010,Oromia,West Hararge,Boke,36,52,82,170
Yekatit,6th,2010,Oromia,West Hararge,Chiro Town,91,71,63,225
Ginbot,9th,2011,Oromia,East Hararge,Babile Woreda,27,83,50,160
Meskerem,1st,2011,Oromia,South West Shewa,Tole,15,70,27,112
Miyazia,8th,2011,Oromia,Jimma,Nono Benja,28,53,23,104
Sene,10th,2009,Oromia,Horo Gudru Wellega,Hababo Guduru,44,63,94,201
Nehase,12th,2009,Oromia,East Hararge,Garemuleta Hospital,71,82,12,165
Teqemt,2nd,2010,Oromia,South West Shewa,St.Luke Hospital,43,98,28,169
Ginbot,9th,2010,Oromia,Ilu Aba Bora,Yayu,74,14,48,136
Tir,5th,2011,Oromia,Ilu Aba Bora,Bilonopa,5,4,51,60
Miyazia,8th,2010,Oromia,West Hararge,Meiso,33,25,80,138
Megabit,7th,2010,Oromia,Jimma,Limu Hospital,5,32,35,72
Teqemt,2nd,2011,Oromia,Arsi,Hitosa,39,98,83,220
Miyazia,8th,2011,Oromia,Arsi,Shirka,12,52,78,142
Tahesas,4th,2010,Oromia,West Wellega,Nole Kaba,17,48,1,66
Yekatit,6th,2009,Oromia,Guji,Adola Town,51,43,24,118
Miyazia,8th,2011,Oromia,Horo Gudru Wellega,Horo,57,13,77,147
Ginbot,9th,2011,Oromia,East Hararge,Aweday Town,62,42,29,133
Hamle,11th,2010,Oromia,West Guji,Kercha Hospital,69,64,25,158
Hedar,3rd,2011,Oromia,West Wellega,Seyo Nole,50,31,19,100
Megabit,7th,2011,Oromia,West Shewa,Meta Waliqite,70,14,93,177
Sene,10th,2009,Oromia,West Wellega,Boji Cheqorsa,66,64,86,216
Ginbot,9th,2009,Oromia,Qeleme Wellega,Gidami,12,71,88,171
Yekatit,6th,2011,Oromia,West Shewa,Jibat,70,99,95,264
Ginbot,9th,2009,Oromia,West Arsi,Gambo Hospital,10,10,78,98
Teqemt,2nd,2010,Oromia,North Shewa,Hidabu Abote,66,3,41,110
Ginbot,9th,2010,Oromia,North Shewa,Hidabu Abote,75,20,9,104
Sene,10th,2010,Oromia,West Wellega,Begi,28,33,40,101
Ginbot,9th,2011,Oromia,West Guji,Gelana,30,1,43,74
Tir,5th,2011,Oromia,Arsi,Enkelo Wabe,50,38,93,181
Tir,5th,2011,Oromia,Jimma,Agaro Hospital,17,49,68,134
Megabit,7th,2010,Oromia,West Arsi,Shashemene Rural,15,30,12,57
Hedar,3rd,2010,Oromia,West Arsi,Kore,74,31,62,167
Tir,5th,2009,Oromia,East Hararge,Chelenko Hospital,78,14,50,142
Ginbot,9th,2009,Oromia,Ilu Aba Bora,Doreni,74,81,27,182
Miyazia,8th,2011,Oromia,Buno Bedele,Bedele Zuriya,39,98,50,187
Ginbot,9th,2011,Oromia,Arsi,Seru,71,18,68,157
Ginbot,9th,2011,Oromia,East Shewa,Boset,90,76,64,230
Hedar,3rd,2011,Oromia,Arsi,Dodota,80,55,23,158
Tir,5th,2011,Oromia,East Hararge,Meyu Muleke,2,63,48,113
Hamle,11th,2010,Oromia,Borena,Yabelo Rural,48,79,14,141
Tir,5th,2009,Oromia,West Hararge,Boke,2,17,99,118
Megabit,7th,2010,Oromia,East Hararge,Goro Gutu,75,19,70,164
Megabit,7th,2009,Oromia,Horo Gudru Wellega,Jima Rare,98,84,0,182
Megabit,7th,2009,Oromia,Arsi,Bekoji Town,69,94,29,192
Ginbot,9th,2009,Oromia,Dukem Town,Dukem Town,97,20,73,190
Nehase,12th,2010,Oromia,East Shewa,Lomme,57,2,38,97
Ginbot,9th,2011,Oromia,West Hararge,Meiso,27,54,59,140
Megabit,7th,2011,Oromia,East Shewa,Adami Tulu Jido Kombolcha,51,84,68,203
Miyazia,8th,2011,Oromia,West Hararge,Mesela,86,6,67,159
Ginbot,9th,2009,Oromia,Arsi,Ludehetosa,83,48,85,216
Miyazia,8th,2011,Oromia,West Shewa,Ambo Hospital,89,15,6,110
Ginbot,9th,2009,Oromia,West Wellega,Boji Cheqorsa,69,33,73,175
Tir,5th,2010,Oromia,East Wellega,Sasiga,82,92,74,248
Hedar,3rd,2010,Oromia,Ilu Aba Bora,Becho,29,16,37,82
Tir,5th,2009,Oromia,Bale,Gololcha,83,25,64,172
Meskerem,1st,2011,Oromia,Bale,Goro,36,51,91,178
Hedar,3rd,2010,Oromia,East Hararge,Melka Belo,59,82,12,153
Ginbot,9th,2010,Oromia,West Shewa,Metarobi,68,45,30,143
Miyazia,8th,2010,Oromia,Borena,Wachile,38,35,80,153
Hedar,3rd,2010,Oromia,West Shewa,Gedo Hospital,50,60,72,182
Megabit,7th,2010,Oromia,East Hararge,Gole Oda,96,67,9,172
Yekatit,6th,2010,Oromia,West Shewa,Ilu Galan,19,45,8,72
Meskerem,1st,2011,Oromia,West Guji,Bule Hora Hospital,74,97,35,206
Ginbot,9th,2011,Oromia,Finfine Zuria,Sandefa,16,96,41,153
Meskerem,1st,2011,Oromia,East Hararge,Kumbi,0,82,86,168
Hamle,11th,2010,Oromia,Arsi,Bekoji Town,18,65,30,113
Nehase,12th,2009,Oromia,West Hararge,Gelemso Hospital,86,64,69,219
Tir,5th,2010,Oromia,West Shewa,Ejerie,11,75,46,132
Nehase,12th,2009,Oromia,Horo Gudru Wellega,Gudru,16,48,43,107
Megabit,7th,2011,Oromia,West Shewa,Ginde Beret,22,39,76,137
Nehase,12th,2009,Oromia,West Arsi,Wondo,28,87,45,160
Meskerem,1st,2010,Oromia,Jimma,Limu Hospital,22,5,19,46
Teqemt,2nd,2010,Oromia,East Hararge,Meyu Muleke,64,23,96,183
Meskerem,1st,2011,Oromia,Qeleme Wellega,Dale Sedi,84,32,91,207
Teqemt,2nd,2011,Oromia,Jimma,Omonada,98,31,95,224
Teqemt,2nd,2011,Oromia,West Arsi,Kore,59,40,20,119
Tir,5th,2009,Oromia,Qeleme Wellega,Hawa Gelan,45,99,69,213
Megabit,7th,2010,Oromia,East Shewa,Gimbichu,79,63,95,237
Hedar,3rd,2011,Oromia,Qeleme Wellega,Dale Wabera,87,78,39,204
Hedar,3rd,2011,Oromia,West Wellega,Nole Kaba,6,69,37,112
Ginbot,9th,2009,Oromia,West Hararge,Oda Bultum,12,16,50,78
Sene,10th,2010,Oromia,Jimma,Omonada,26,59,91,176
Ginbot,9th,2011,Oromia,West Arsi,Dodola Town,13,57,23,93
Tir,5th,2010,Oromia,West Wellega,Haru,9,91,90,190
Hamle,11th,2010,Oromia,Burayu Town,Burayu Town,85,56,36,177
Tir,5th,2011,Oromia,West Shewa,Codi,44,42,54,140
Teqemt,2nd,2010,Oromia,Qeleme Wellega,Seyo,16,52,35,103
Megabit,7th,2011,Oromia,East Wellega,Sibu Sire,18,85,17,120
Tir,5th,2011,Oromia,Bale,Ginir,20,88,51,159
Miyazia,8th,2009,Oromia,Bale,Berbere,28,42,53,123
Megabit,7th,2009,Oromia,Jimma,Dedo,73,49,64,186
Megabit,7th,2011,Oromia,Finfine Zuria,Akaki,58,75,40,173
Ginbot,9th,2011,Oromia,West Guji,Gelana,32,93,54,179
Megabit,7th,2010,Oromia,West Wellega,Mendi Town,39,45,56,140
Tahesas,4th,2010,Oromia,Modjo Town,Modjo Town,29,25,83,137
Miyazia,8th,2009,Oromia,Jimma,Limu Hospital,11,21,61,93
Miyazia,8th,2011,Oromia,Horo Gudru Wellega,Abe Dengoro,73,14,48,135
Megabit,7th,2009,Oromia,West Shewa,Dano,99,7,41,147
Yekatit,6th,2009,Oromia,Jimma,Setema,82,31,25,138
Meskerem,1st,2010,Oromia,Arsi,Ludehetosa,68,47,12,127
Tahesas,4th,2010,Oromia,Dukem Town,Dukem Town,63,18,96,177
Hedar,3rd,2010,Oromia,West Wellega,Babo Gembel,78,68,34,180
Megabit,7th,2009,Oromia,West Shewa,Metarobi,18,0,94,112
Miyazia,8th,2009,Oromia,East Hararge,Bisidimo Hospital,25,9,37,71
Tir,5th,2009,Oromia,West Arsi,Wondo,92,0,10,102
Megabit,7th,2011,Oromia,Jimma,Seka Chhokorsa Hospital,74,68,26,168
Megabit,7th,2010,Oromia,West Shewa,Codi,16,90,54,160
Hedar,3rd,2011,Oromia,West Shewa,Ambo Hospital,43,35,64,142
Nehase,12th,2010,Oromia,West Wellega,Gimbi,73,99,75,247
Ginbot,9th,2010,Oromia,South West Shewa,Bantu  Hospital,20,28,40,88
Megabit,7th,2009,Oromia,Arsi,Deksis,95,56,26,177
Tir,5th,2010,Oromia,Buno Bedele,Bedele Town,50,50,73,173
Meskerem,1st,2010,Oromia,Buno Bedele,Meko,2,96,81,179
Hamle,11th,2009,Oromia,West Arsi,Hebal Arsi,42,18,65,125
Sene,10th,2011,Oromia,East Hararge,Gursum,69,93,49,211
Tir,5th,2010,Oromia,Borena,Meyo,99,72,69,240
Yekatit,6th,2009,Oromia,South West Shewa,Goro,12,68,46,126
Ginbot,9th,2009,Oromia,East Hararge,Kombolicha,88,91,34,213
Tir,5th,2011,Oromia,Arsi,Aseko,13,95,29,137
Sene,10th,2010,Oromia,West Shewa,Jibat,98,27,70,195
Tahesas,4th,2011,Oromia,Shashamane Town,Shashamane Town,98,23,83,204
Sene,10th,2009,Oromia,West Guji,Bule Hora Toun,8,4,94,106
Teqemt,2nd,2010,Oromia,West Arsi,Wondo,34,87,55,176
Miyazia,8th,2011,Oromia,Borena,Dire,61,46,15,122
Hedar,3rd,2010,Oromia,Jimma,Limu Kosa,60,21,36,117
Sene,10th,2010,Oromia,West Arsi,Kore,38,14,2,54
Meskerem,1st,2010,Oromia,West Guji,Mkelka Soda,90,84,43,217
Teqemt,2nd,2010,Oromia,East Shewa,Dugda,81,10,77,168
Nehase,12th,2010,Oromia,Ilu Aba Bora,Hurumu,15,99,99,213
Tir,5th,2011,Oromia,West Arsi,Wondo,66,8,45,119
Ginbot,9th,2011,Oromia,West Wellega,Begi,92,83,72,247
Meskerem,1st,2010,Oromia,Jimma,Limu Seka,1,86,91,178
Hamle,11th,2010,Oromia,Borena,Teltele,53,6,85,144
Hamle,11th,2009,Oromia,West Shewa,Jibat,8,32,68,108
Tir,5th,2010,Oromia,West Wellega,Guliso,31,63,93,187
Tir,5th,2009,Oromia,West Shewa,Guder Hosp,52,91,97,240
Tir,5th,2011,Oromia,West Shewa,Codi,8,69,10,87
Yekatit,6th,2010,Oromia,Bale,Ginir,80,57,7,144
Meskerem,1st,2010,Oromia,Qeleme Wellega,Dale Sedi,95,45,33,173
Megabit,7th,2011,Oromia,Jimma,Tiro Afeta,53,4,11,68
Megabit,7th,2011,Oromia,East Shewa,Boset,68,85,30,183
Tir,5th,2009,Oromia,West Shewa,Metarobi,8,50,52,110
Ginbot,9th,2011,Oromia,Arsi,Deksis,59,97,46,202
Tahesas,4th,2011,Oromia,Borena,Wachile,77,37,35,149
Sene,10th,2010,Oromia,East Wellega,Gida Ayana,65,97,24,186
Miyazia,8th,2009,Oromia,Jimma,Sigmo,3,34,85,122
Yekatit,6th,2011,Oromia,Ilu Aba Bora,Metu Rural,46,4,90,140
Hedar,3rd,2010,Oromia,West Shewa,Bako Tibe,44,37,90,171
Megabit,7th,2010,Oromia,Jimma Spe Town,Jimma Spe Town,42,37,63,142
Sene,10th,2010,Oromia,Bale,Delo Mena,66,71,70,207
Ginbot,9th,2011,Oromia,West Shewa,Ambo University  Hosp,67,21,19,107
Tir,5th,2010,Oromia,West Guji,Bule Hora Hospital,71,95,3,169
Nehase,12th,2009,Oromia,Bale,Sinana,91,13,7,111
Sene,10th,2009,Oromia,East Shewa,Olanciti Hospital,39,90,63,192
Hamle,11th,2010,Oromia,South West Shewa,Woliso Rural,59,29,24,112
Megabit,7th,2010,Oromia,East Hararge,Deder Hospital,18,78,98,194
Yekatit,6th,2011,Oromia,West Shewa,Ilu Galan,34,33,36,103
Hedar,3rd,2011,Oromia,Ilu Aba Bora,Darimu,40,64,68,172
Miyazia,8th,2011,Oromia,East Wellega,Kiremu,41,39,60,140
Ginbot,9th,2010,Oromia,North Shewa,Kuyu,56,6,56,118
Hamle,11th,2009,Oromia,Buno Bedele,Boricha,58,23,57,138
Megabit,7th,2010,Oromia,North Shewa,Yaya Gulele,17,75,4,96
Yekatit,6th,2010,Oromia,Jimma,Gomma,52,6,50,108
Miyazia,8th,2010,Oromia,West Guji,Kercha,96,2,28,126
Megabit,7th,2010,Oromia,North Shewa,Dera,69,32,33,134
Teqemt,2nd,2010,Oromia,West Wellega,Mendi Hospital,20,59,95,174
Tir,5th,2010,Oromia,Horo Gudru Wellega,Hababo Guduru,92,27,88,207
Hedar,3rd,2011,Oromia,West Hararge,Anchar,3,34,72,109
Tir,5th,2011,Oromia,South West Shewa,Wonchi,64,56,81,201
Tahesas,4th,2011,Oromia,West Wellega,Nejo Hospital,2,72,57,131
Megabit,7th,2010,Oromia,Bale,Dawe Serar,18,2,65,85
Miyazia,8th,2010,Oromia,Sebeta Town,Sebeta Town,4,84,6,94
Nehase,12th,2010,Oromia,East Wellega,Guto Gida,43,98,45,186
Tir,5th,2010,Oromia,Borena,Wachile,33,51,35,119
Nehase,12th,2009,Oromia,West Guji,Abaya,45,94,3,142
Miyazia,8th,2011,Oromia,West Shewa,Jeldu,26,8,48,82
Megabit,7th,2009,Oromia,West Shewa,Gedo Hospital,81,80,68,229
Tir,5th,2011,Oromia,Ilu Aba Bora,Metu Rural,3,93,48,144
Hedar,3rd,2010,Oromia,Bale,Gololcha,19,25,96,140
Tir,5th,2011,Oromia,Ilu Aba Bora,Becho,76,34,76,186
Ginbot,9th,2009,Oromia,West Hararge,Chiro Hospital,23,56,3,82
Hedar,3rd,2011,Oromia,East Wellega,Sibu Sire,6,14,52,72
Hamle,11th,2010,Oromia,Guji,Adola Reda,56,25,31,112
Megabit,7th,2011,Oromia,North Shewa,Fiche Hospital,91,42,54,187
Ginbot,9th,2009,Oromia,North Shewa,Kuyu Hospital,54,14,99,167
Yekatit,6th,2010,Oromia,Buno Bedele,Chewaqa,53,11,68,132
Yekatit,6th,2010,Oromia,Arsi,Bale Gesgara,71,15,7,93
Ginbot,9th,2011,Oromia,West Arsi,Shashemene Rural,1,73,17,91
Miyazia,8th,2010,Oromia,East Wellega,Diga,92,79,23,194
Nehase,12th,2010,Oromia,North Shewa,Wuchale,76,85,11,172
Nehase,12th,2009,Oromia,Jimma,Mana,34,52,61,147
Hedar,3rd,2011,Oromia,West Hararge,Chiro Hospital,85,42,29,156
Yekatit,6th,2011,Oromia,Qeleme Wellega,Gidami Hosp,23,90,80,193
Tahesas,4th,2011,Oromia,East Shewa,Gimbichu,0,10,72,82
Ginbot,9th,2010,Oromia,West Arsi,Kofele,47,63,11,121
Yekatit,6th,2011,Oromia,Jimma,Setema Hospital,67,89,67,223
Teqemt,2nd,2010,Oromia,West Hararge,Mesela,30,41,6,77
Tahesas,4th,2011,Oromia,Borena,Meyo,83,53,53,189
Yekatit,6th,2010,Oromia,East Shewa,Liben,91,52,87,230
Hedar,3rd,2010,Oromia,West Wellega,Nejo Hospital,58,84,93,235
Sene,10th,2009,Oromia,Jimma,Mana,69,38,16,123
Tir,5th,2009,Oromia,East Wellega,Wama Hagelo,26,78,63,167
Megabit,7th,2011,Oromia,Guji,Saba Boru,30,91,3,124
Yekatit,6th,2011,Oromia,West Wellega,Nejo Hospital,25,25,32,82
Meskerem,1st,2011,Oromia,Qeleme Wellega,Dale Sedi,94,90,71,255
Hamle,11th,2010,Oromia,Borena,Yabelo Hospital,25,80,83,188
Nehase,12th,2010,Oromia,Buno Bedele,Bedele Hospital,96,45,34,175
Miyazia,8th,2010,Oromia,West Wellega,Mendi Town,23,65,29,117
Tahesas,4th,2011,Oromia,Holeta Town,Holeta Town,84,7,30,121
Ginbot,9th,2010,Oromia,Qeleme Wellega,Dale Sedi,31,72,91,194
Meskerem,1st,2011,Oromia,Guji,Dima,99,97,33,229
Nehase,12th,2010,Oromia,West Arsi,Shashemene Rural,86,10,79,175
Teqemt,2nd,2010,Oromia,West Guji,Biebirsa Kojowa,76,60,37,173
Hedar,3rd,2011,Oromia,Gelan Town,Gelan Town,2,79,24,105
Meskerem,1st,2010,Oromia,East Hararge,Jarso,99,21,80,200
Tir,5th,2009,Oromia,Arsi,Ludehetosa,30,9,44,83
Miyazia,8th,2011,Oromia,East Wellega,Limu,21,41,29,91
Sene,10th,2009,Oromia,Arsi,Amigna,6,91,72,169
Meskerem,1st,2010,Oromia,West Arsi,Adaba,43,47,10,100
Tir,5th,2009,Oromia,Arsi,Guna,49,17,9,75
Miyazia,8th,2009,Oromia,West Hararge,Habro,26,99,95,220
Megabit,7th,2009,Oromia,West Arsi,Hebal Arsi,55,79,69,203
Yekatit,6th,2009,Oromia,Sululta Town,Sululta Town,27,79,23,129
Yekatit,6th,2010,Oromia,Arsi,Sude,83,60,14,157
Yekatit,6th,2011,Oromia,Guji,Hambela Wamena,71,94,39,204
Yekatit,6th,2010,Oromia,Bale,Gasera,69,62,72,203
Sene,10th,2009,Oromia,North Shewa,Kuyu Hospital,96,38,27,161
Ginbot,9th,2009,Oromia,South West Shewa,Wonchi,99,98,96,293
Teqemt,2nd,2011,Oromia,Qeleme Wellega,Dambi Dolo Hospital,91,22,29,142
Hamle,11th,2010,Oromia,West Guji,Mkelka Soda,29,38,67,134
Yekatit,6th,2010,Oromia,West Guji,Suro Barguda,46,43,67,156
Yekatit,6th,2009,Oromia,East Shewa,Lomme,33,71,4,108
Nehase,12th,2010,Oromia,Qeleme Wellega,Dale Sedi,82,89,48,219
Yekatit,6th,2010,Oromia,Sululta Town,Sululta Town,15,86,93,194
Miyazia,8th,2011,Oromia,Bale,Dawe Qachen,43,35,21,99
Miyazia,8th,2010,Oromia,Bale,Gololcha,80,9,39,128
Ginbot,9th,2010,Oromia,North Shewa,Aleiltu,74,30,97,201
Miyazia,8th,2011,Oromia,East Hararge,Kurfa Chele,45,85,29,159
Tir,5th,2011,Oromia,Arsi,Munesa,81,15,62,158
Ginbot,9th,2010,Oromia,West Hararge,Gelemso Hospital,88,36,66,190
Miyazia,8th,2009,Oromia,Bale,Arena Buluq,5,22,11,38
Sene,10th,2009,Oromia,Ilu Aba Bora,Didu,87,67,47,201
Miyazia,8th,2009,Oromia,Arsi,Ludehetosa,17,45,87,149
Hamle,11th,2010,Oromia,West Shewa,Elifata,57,58,31,146
Tir,5th,2011,Oromia,Guji,Girja,25,15,0,40
Megabit,7th,2009,Oromia,East Hararge,Kombolicha,50,45,78,173
Yekatit,6th,2009,Oromia,West Wellega,Nejo Hospital,2,70,80,152
Tir,5th,2011,Oromia,Borena,Arero,95,67,56,218
Hamle,11th,2010,Oromia,Guji,Uraga,66,97,80,243
Teqemt,2nd,2010,Oromia,East Shewa,Liben,31,79,7,117
Nehase,12th,2010,Oromia,Assela Town,Assela Town,54,57,39,150
Tir,5th,2011,Oromia,South West Shewa,Ilu,84,34,40,158
Hedar,3rd,2011,Oromia,North Shewa,Abichugna,73,73,73,219
Tir,5th,2009,Oromia,Guji,Adola Town,69,12,16,97
Tir,5th,2011,Oromia,Finfine Zuria,Sululta Town,54,86,85,225
Tahesas,4th,2011,Oromia,Qeleme Wellega,Gidami,36,61,12,109
Hamle,11th,2010,Oromia,Qeleme Wellega,Yemalogi Wolel,70,96,33,199
Sene,10th,2011,Oromia,East Hararge,Babile,68,16,88,172
Sene,10th,2010,Oromia,West Arsi,Dodola Town,95,1,9,105
Tahesas,4th,2010,Oromia,West Shewa,Ambo,27,15,64,106
Tahesas,4th,2011,Oromia,West Wellega,Homa,40,5,14,59
Meskerem,1st,2011,Oromia,Lege Dadi Lege Tafo Town,Lege Dadi Lege Tafo Town,95,45,28,168
Miyazia,8th,2011,Oromia,South West Shewa,Sodo Dac'Ha,93,2,30,125
Nehase,12th,2010,Oromia,South West Shewa,Bantu  Hospital,59,23,24,106
Miyazia,8th,2011,Oromia,Guji,Odo Shakiso,35,57,37,129
Hedar,3rd,2010,Oromia,Guji,Anna Sora,64,62,47,173
Hedar,3rd,2011,Oromia,Buno Bedele,Chewaqa,42,98,46,186
Hamle,11th,2010,Oromia,Arsi,Munesa,73,35,73,181
Ginbot,9th,2009,Oromia,Ilu Aba Bora,Becho,9,36,10,55
Sene,10th,2011,Oromia,West Shewa,Inchini Hospital,56,45,36,137
Hamle,11th,2009,Oromia,East Wellega,Gudeyabila,76,54,87,217
Nehase,12th,2010,Oromia,Sebeta Town,Sebeta Town,91,96,34,221
Sene,10th,2009,Oromia,Ilu Aba Bora,Bure,77,37,15,129
Miyazia,8th,2011,Oromia,East Hararge,Babile Woreda,34,72,58,164
Yekatit,6th,2010,Oromia,Arsi,Digeluna Tijo,82,91,92,265
Hedar,3rd,2011,Oromia,Arsi,Sire,69,56,40,165
Tir,5th,2011,Oromia,Horo Gudru Wellega,Horro Buluk,97,28,30,155
Yekatit,6th,2010,Oromia,Gelan Town,Gelan Town,13,12,43,68
Nehase,12th,2010,Oromia,West Shewa,Midakegni,86,69,82,237
Ginbot,9th,2010,Oromia,East Wellega,Nunu Qumba,7,84,10,101
Sene,10th,2009,Oromia,Jimma,Limu Kosa,45,72,41,158
Ginbot,9th,2010,Oromia,Guji,Liben,88,53,55,196
Megabit,7th,2011,Oromia,Jimma,Nono Benja,90,69,66,225
Nehase,12th,2010,Oromia,Arsi,Dodota,59,41,3,103
Yekatit,6th,2011,Oromia,West Arsi,Kokosa,86,60,81,227
Tir,5th,2009,Oromia,West Shewa,Abuna Gindeberet,48,48,29,125
Sene,10th,2011,Oromia,East Shewa,Adea,49,89,98,236
Hedar,3rd,2011,Oromia,East Hararge,Midega Tole,19,39,5,63
Tahesas,4th,2011,Oromia,West Arsi,Shashemene Rural,12,51,10,73
Tahesas,4th,2010,Oromia,Finfine Zuria,Berreh,29,47,42,118
Tahesas,4th,2010,Oromia,North Shewa,Aleiltu,53,11,38,102
Tir,5th,2010,Oromia,East Hararge,Deder,61,14,96,171
Miyazia,8th,2009,Oromia,West Arsi,Wondo,16,85,57,158
Miyazia,8th,2011,Oromia,North Shewa,Hidabu Abote,10,42,78,130
Sene,10th,2011,Oromia,Arsi,Merti,86,80,94,260
Megabit,7th,2011,Oromia,West Wellega,Mendi Hospital,66,81,48,195
Sene,10th,2011,Oromia,South West Shewa,Seden Sodo,70,0,11,81
Hamle,11th,2010,Oromia,East Shewa,Bora,60,73,85,218
Ginbot,9th,2010,Oromia,Arsi,Seru,37,4,89,130
Miyazia,8th,2010,Oromia,Horo Gudru Wellega,Chomen Guduru,35,4,80,119
Hedar,3rd,2010,Oromia,Ilu Aba Bora,Nono Sele,99,81,71,251
Sene,10th,2011,Oromia,Woliso Town,Woliso Town,27,25,84,136
Nehase,12th,2010,Oromia,West Hararge,Chiro Hospital,80,61,96,237
Teqemt,2nd,2010,Oromia,West Hararge,Gelemso Hospital,56,29,21,106
Nehase,12th,2010,Oromia,East Shewa,Batu,33,8,99,140
Hamle,11th,2009,Oromia,Jimma,Limu Hospital,2,28,84,114
Hamle,11th,2010,Oromia,West Wellega,Babo Gembel,12,18,44,74
Hamle,11th,2009,Oromia,Jimma,Seka Chekorsa,34,44,6,84
Yekatit,6th,2009,Oromia,South West Shewa,St.Luke Hospital,79,53,56,188
Ginbot,9th,2011,Oromia,Horo Gudru Wellega,Horro Buluk,77,86,37,200
Nehase,12th,2009,Oromia,West Guji,Bule Hora Hospital,56,18,72,146
Yekatit,6th,2009,Oromia,East Wellega,Limu,51,59,29,139
Yekatit,6th,2010,Oromia,Horo Gudru Wellega,Abay Chomen,77,8,26,111
Hedar,3rd,2010,Oromia,Jimma,Nono Benja,2,39,53,94
Nehase,12th,2009,Oromia,South West Shewa,Tole,14,84,21,119
Teqemt,2nd,2011,Oromia,West Shewa,Ejersa Lafo,47,85,92,224
Sene,10th,2009,Oromia,Assela Town,Assela Town,21,69,68,158
Hamle,11th,2009,Oromia,Burayu Town,Burayu Town,77,88,94,259
Hedar,3rd,2010,Oromia,South West Shewa,Becho,14,74,9,97
Hedar,3rd,2011,Oromia,Qeleme Wellega,Hawa Gelan,41,86,59,186
Sene,10th,2009,Oromia,Buno Bedele,Chewaqa,22,30,49,101
Ginbot,9th,2010,Oromia,East Hararge,Haromaya Hospital,90,93,35,218
Teqemt,2nd,2011,Oromia,Arsi,Digeluna Tijo,8,76,14,98
Hedar,3rd,2010,Oromia,West Guji,Suro Barguda,87,64,3,154
Ginbot,9th,2011,Oromia,East Wellega,Guto Gida,92,56,88,236
Miyazia,8th,2009,Oromia,East Shewa,Adami Tulu Jido Kombolcha,72,29,99,200
Ginbot,9th,2009,Oromia,Bale,Raitu,14,7,33,54
Megabit,7th,2011,Oromia,Arsi,Dodota,39,53,41,133
Hamle,11th,2009,Oromia,Arsi,Sire,6,31,12,49
Tir,5th,2009,Oromia,West Arsi,Shashemene Rural,96,56,97,249
Yekatit,6th,2011,Oromia,West Shewa,Codi,10,93,57,160
Tir,5th,2011,Oromia,Guji,Negele Hospital,0,11,50,61
Teqemt,2nd,2010,Oromia,Bale,Legehida,56,21,36,113
Ginbot,9th,2011,Oromia,West Shewa,Midakegni,93,37,40,170
Yekatit,6th,2009,Oromia,Bale,Legehida,76,88,22,186
Hamle,11th,2010,Oromia,East Shewa,Adami Tulu Jido Kombolcha,85,8,88,181
Ginbot,9th,2009,Oromia,Arsi,Zeway Dugda,29,16,59,104
Teqemt,2nd,2011,Oromia,North Shewa,Degem,42,68,22,132
Miyazia,8th,2011,Oromia,East Hararge,Gursum,6,45,24,75
Megabit,7th,2010,Oromia,Horo Gudru Wellega,Jima Rare,67,40,19,126
Ginbot,9th,2011,Oromia,Guji,Goro Dola,84,43,92,219
Teqemt,2nd,2010,Oromia,Borena,Moyale,6,68,30,104
Megabit,7th,2009,Oromia,West Wellega,Nole Kaba,86,55,1,142
Hedar,3rd,2010,Oromia,East Hararge,Chelenko Hospital,59,78,84,221
Tahesas,4th,2010,Oromia,East Hararge,Chelenko Hospital,64,40,97,201
Megabit,7th,2009,Oromia,Arsi,Shirka,40,10,10,60
Yekatit,6th,2010,Oromia,West Shewa,Abuna Gindeberet,73,26,55,154
Yekatit,6th,2009,Oromia,Ilu Aba Bora,Metu Town,35,31,22,88
Miyazia,8th,2009,Oromia,West Wellega,Boji Dermeji,96,52,30,178
Miyazia,8th,2010,Oromia,East Hararge,Haromaya Hospital,16,67,78,161
Ginbot,9th,2011,Oromia,East Hararge,Midega Tole,1,90,8,99
Ginbot,9th,2009,Oromia,Ilu Aba Bora,Bure,46,67,63,176
Meskerem,1st,2011,Oromia,Qeleme Wellega,Yemalogi Wolel,61,23,24,108
Tir,5th,2010,Oromia,South West Shewa,Ameya,11,38,74,123
Hedar,3rd,2011,Oromia,Qeleme Wellega,Gawo Qebe,65,58,72,195
Teqemt,2nd,2011,Oromia,East Shewa,Boset,36,58,60,154
Teqemt,2nd,2010,Oromia,East Shewa,Adami Tulu Jido Kombolcha,2,92,16,110
Miyazia,8th,2010,Oromia,East Shewa,Bora,48,99,28,175
Teqemt,2nd,2011,Oromia,East Hararge,Kurfa Chele,22,89,6,117
Sene,10th,2009,Oromia,South West Shewa,Dawo,94,93,67,254
Sene,10th,2010,Oromia,West Hararge,Tulo,51,14,11,76
Meskerem,1st,2011,Oromia,West Hararge,Gelemso Hospital,79,2,71,152
Miyazia,8th,2009,Oromia,West Hararge,Chiro Town,70,89,28,187
Ginbot,9th,2009,Oromia,West Hararge,Bedesa Town,74,55,94,223
Tir,5th,2011,Oromia,Jimma,Setema Hospital,7,2,83,92
Tahesas,4th,2010,Oromia,Ilu Aba Bora,Didu,6,43,81,130
Miyazia,8th,2010,Oromia,Finfine Zuria,Sululta Town,74,99,49,222
Hedar,3rd,2010,Oromia,West Wellega,Seyo Nole,67,47,22,136
Sene,10th,2010,Oromia,South West Shewa,Seden Sodo,65,87,58,210
Yekatit,6th,2011,Oromia,North Shewa,Aleiltu,60,93,75,228
Sene,10th,2009,Oromia,West Wellega,Genji,38,30,69,137
Nehase,12th,2010,Oromia,Lege Dadi Lege Tafo Town,Lege Dadi Lege Tafo Town,7,63,81,151
Megabit,7th,2009,Oromia,North Shewa,Abichugna,61,83,14,158
Miyazia,8th,2011,Oromia,Ilu Aba Bora,Metu Town,11,24,78,113
Yekatit,6th,2011,Oromia,West Wellega,Kundala,19,9,11,39
Nehase,12th,2010,Oromia,Sebeta Town,Sebeta Town,56,49,32,137
Hedar,3rd,2010,Oromia,Jimma,Setema,76,22,13,111
Miyazia,8th,2010,Oromia,Qeleme Wellega,Dambi Dolo Hospital,95,71,32,198
Miyazia,8th,2010,Oromia,West Shewa,Ambo,80,87,14,181
Tir,5th,2011,Oromia,North Shewa,Aleiltu,40,45,56,141
Meskerem,1st,2011,Oromia,Finfine Zuria,Walmera,99,37,54,190
Ginbot,9th,2009,Oromia,West Arsi,Gedeb Asasa,23,41,41,105
Sene,10th,2009,Oromia,North Shewa,Dera,29,26,81,136
Yekatit,6th,2010,Oromia,West Guji,Abaya,51,25,14,90
Yekatit,6th,2009,Oromia,Buno Bedele,Chewaqa,21,38,40,99
Sene,10th,2010,Oromia,North Shewa,Dera,41,64,37,142
Tir,5th,2011,Oromia,Bale,Raitu,50,50,87,187
Ginbot,9th,2010,Oromia,West Shewa,Gedo Hospital,58,79,31,168
Hedar,3rd,2011,Oromia,Qeleme Wellega,Gidami Hosp,86,48,78,212
Megabit,7th,2009,Oromia,Qeleme Wellega,Gawo Qebe,83,73,17,173
Ginbot,9th,2010,Oromia,Ilu Aba Bora,Nono Sele,12,92,54,158
Miyazia,8th,2010,Oromia,West Shewa,Metarobi,36,93,86,215
Hamle,11th,2009,Oromia,West Shewa,Ilu Galan,17,28,36,81
Megabit,7th,2010,Oromia,Bale,Goba Town,26,72,70,168
Ginbot,9th,2009,Oromia,Bale,Gasera,4,78,40,122
Nehase,12th,2010,Oromia,Holeta Town,Holeta Town,91,31,8,130
Yekatit,6th,2011,Oromia,Bale,Seweyna,9,75,39,123
Nehase,12th,2009,Oromia,North Shewa,Were Jarso,0,66,81,147
Nehase,12th,2009,Oromia,West Wellega,Mendi Hospital,79,16,49,144
Miyazia,8th,2009,Oromia,West Wellega,Mendi Town,80,10,44,134
Megabit,7th,2010,Oromia,Arsi,Chole,5,98,35,138
Megabit,7th,2010,Oromia,West Hararge,Bedesa Town,28,79,67,174
Miyazia,8th,2011,Oromia,Arsi,Merti,88,63,68,219
Sene,10th,2009,Oromia,West Shewa,Dano,94,75,57,226
Ginbot,9th,2011,Oromia,Guji,Liben,82,80,69,231
Hamle,11th,2009,Oromia,Arsi,Aseko,79,66,6,151
Nehase,12th,2010,Oromia,Bale,Gasera,93,21,24,138
Yekatit,6th,2010,Oromia,Ilu Aba Bora,Didu,41,48,95,184
Yekatit,6th,2009,Oromia,South West Shewa,Tole,61,65,84,210
Nehase,12th,2009,Oromia,Horo Gudru Wellega,Hababo Guduru,95,9,12,116
Nehase,12th,2010,Oromia,West Wellega,Gimbi Rural,59,24,14,97
Hedar,3rd,2011,Oromia,Bale,Gura Dhamole,22,9,57,88
Meskerem,1st,2011,Oromia,Arsi,Deksis,11,52,40,103
Meskerem,1st,2010,Oromia,Borena,Guchi,32,5,67,104
Miyazia,8th,2010,Oromia,Buno Bedele,Boricha,3,17,9,29
Nehase,12th,2009,Oromia,Bale,Agarfa,19,29,75,123
Ginbot,9th,2011,Oromia,Jimma,Gomma,79,69,78,226
Megabit,7th,2011,Oromia,Jimma Spe Town,Jimma Spe Town,76,35,49,160
Megabit,7th,2009,Oromia,West Arsi,Hebal Arsi,98,44,26,168
Yekatit,6th,2011,Oromia,Jimma,Gera,41,12,5,58
Yekatit,6th,2010,Oromia,West Guji,Dugda Dawa,19,86,52,157
Miyazia,8th,2011,Oromia,North Shewa,Jido,84,87,6,177
Tahesas,4th,2011,Oromia,West Guji,Biebirsa Kojowa,52,29,62,143
Tir,5th,2009,Oromia,Borena,Moyale,19,79,90,188
Sene,10th,2009,Oromia,Ilu Aba Bora,Halu,25,76,85,186
Nehase,12th,2010,Oromia,West Hararge,Gelemso Hospital,44,54,42,140
Meskerem,1st,2011,Oromia,Bale,Raitu,3,13,63,79
Megabit,7th,2011,Oromia,West Hararge,Oda Bultum,38,91,41,170
Hedar,3rd,2010,Oromia,Qeleme Wellega,Gawo Qebe,51,58,75,184
Sene,10th,2009,Oromia,East Shewa,Liben,42,39,65,146
Yekatit,6th,2009,Oromia,East Hararge,Haromaya Hospital,97,77,24,198
Hedar,3rd,2010,Oromia,Finfine Zuria,Mullo,22,21,45,88
Miyazia,8th,2011,Oromia,Arsi,Merti,42,26,95,163
Yekatit,6th,2010,Oromia,South West Shewa,Woliso Rural,69,61,86,216
Nehase,12th,2009,Oromia,West Wellega,Seyo Nole,15,74,99,188
Hedar,3rd,2010,Oromia,Arsi,Sire,16,98,33,147
Miyazia,8th,2010,Oromia,East Hararge,Haromaya Hospital,66,33,38,137
Sene,10th,2009,Oromia,West Hararge,Anchar,69,14,67,150
Yekatit,6th,2010,Oromia,East Shewa,Liben,67,81,16,164
Sene,10th,2010,Oromia,Jimma,Gera,97,9,51,157
Miyazia,8th,2011,Oromia,Ilu Aba Bora,Algesachi,76,86,84,246
Hedar,3rd,2011,Oromia,Arsi,Bale Gesgara,52,67,60,179
Tahesas,4th,2010,Oromia,Jimma,Chora Boter,43,36,93,172
Nehase,12th,2010,Oromia,East Hararge,Deder Town,89,79,50,218
Tir,5th,2010,Oromia,Jimma,Omonada,93,16,12,121
Tir,5th,2011,Oromia,Horo Gudru Wellega,Gudru,0,49,23,72
Yekatit,6th,2010,Oromia,North Shewa,Girar Jarso,45,18,10,73
Ginbot,9th,2009,Oromia,Guji,Aga Wayyu,0,47,28,75
Hedar,3rd,2010,Oromia,Arsi,Sire,35,71,51,157
Ginbot,9th,2010,Oromia,Arsi,Bale Gesgara,35,4,64,103
Tir,5th,2011,Oromia,West Shewa,Gindeberet Hospital,95,88,14,197
Megabit,7th,2010,Oromia,West Wellega,Gimbi,52,30,40,122
Teqemt,2nd,2011,Oromia,Arsi,Munesa,41,49,87,177
Ginbot,9th,2011,Oromia,East Hararge,Haromaya Town,78,78,94,250
Miyazia,8th,2009,Oromia,Horo Gudru Wellega,Amuru,50,13,12,75
Sene,10th,2009,Oromia,Jimma,B/Tolyi,66,19,59,144
Hamle,11th,2010,Oromia,Finfine Zuria,Sebeta Awas,22,4,71,97
Megabit,7th,2011,Oromia,North Shewa,Fiche Hospital,19,44,53,116
Hamle,11th,2009,Oromia,Guji,Negele Hospital,11,55,87,153
Yekatit,6th,2010,Oromia,Ilu Aba Bora,Didu,23,62,72,157
Yekatit,6th,2011,Oromia,Bale,Goro,65,17,43,125
Yekatit,6th,2011,Oromia,West Wellega,Qiltu Kara,39,69,25,133
Yekatit,6th,2009,Oromia,West Arsi,Dodola Town,48,37,96,181
Meskerem,1st,2010,Oromia,Qeleme Wellega,Seyo,47,73,0,120
Teqemt,2nd,2010,Oromia,East Shewa,Fentale,86,87,96,269
Tir,5th,2009,Oromia,Sebeta Town,Sebeta Town,85,58,43,186
Megabit,7th,2009,Oromia,Arsi,Merti,51,74,12,137
Tahesas,4th,2010,Oromia,East Wellega,Jimma Arjo,28,20,12,60
Yekatit,6th,2009,Oromia,West Shewa,Ambo,10,54,44,108
Meskerem,1st,2011,Oromia,West Shewa,Ejersa Lafo,1,80,39,120
Sene,10th,2009,Oromia,South West Shewa,Woliso Rural,8,56,16,80
Teqemt,2nd,2011,Oromia,Buno Bedele,Meko,29,0,72,101
Miyazia,8th,2011,Oromia,West Arsi,Dodola Rural,74,72,60,206
Sene,10th,2011,Oromia,West Hararge,Doba,28,36,2,66
Teqemt,2nd,2010,Oromia,Horo Gudru Wellega,Chomen Guduru,70,94,40,204
Megabit,7th,2009,Oromia,East Shewa,Liben,69,60,42,171
Yekatit,6th,2011,Oromia,East Hararge,Kumbi,25,39,25,89
Tir,5th,2011,Oromia,Guji,Hambela Wamena,68,18,34,120
Miyazia,8th,2011,Oromia,Bale,Gololcha,41,15,19,75
Tahesas,4th,2011,Oromia,Nekemte Town,Nekemte Town,66,75,15,156
Sene,10th,2010,Oromia,West Guji,Hanbala,57,52,89,198
Tir,5th,2011,Oromia,Ilu Aba Bora,Doreni,17,51,7,75
Tahesas,4th,2010,Oromia,Jimma,Guma,52,29,72,153
Yekatit,6th,2009,Oromia,Ilu Aba Bora,Metu Rural,98,3,55,156
Yekatit,6th,2010,Oromia,East Wellega,Haro Limu,7,21,51,79
Yekatit,6th,2009,Oromia,Bale,Berbere,45,65,71,181
Sene,10th,2009,Oromia,Bale,Meda Welabu,55,18,27,100
Ginbot,9th,2011,Oromia,West Guji,Bule Hora,3,71,96,170
Tir,5th,2009,Oromia,West Hararge,West Harerge	Gumbi Bordede,30,40,40,110
Megabit,7th,2010,Oromia,Horo Gudru Wellega,Amuru,42,92,61,195
Yekatit,6th,2009,Oromia,Qeleme Wellega,Seyo,0,32,15,47
Ginbot,9th,2010,Oromia,South West Shewa,Ameya,2,77,98,177
Yekatit,6th,2009,Oromia,East Hararge,Meyu Muleke,6,61,55,122
Meskerem,1st,2011,Oromia,West Shewa,Ejersa Lafo,5,62,46,113
Megabit,7th,2009,Oromia,East Shewa,Adama,92,69,25,186
Ginbot,9th,2011,Oromia,Arsi,Merti,83,60,14,157
Tir,5th,2010,Oromia,Bale,Raitu,86,80,50,216
Hamle,11th,2009,Oromia,Buno Bedele,Boricha,55,32,89,176
Teqemt,2nd,2010,Oromia,Borena,Wachile,89,79,50,218
Tir,5th,2011,Oromia,East Hararge,Haromaya Rural,82,58,29,169
Nehase,12th,2010,Oromia,Bale,Arena Buluq,47,14,88,149
Teqemt,2nd,2010,Oromia,Guji,Negele Town,37,60,47,144
Teqemt,2nd,2010,Oromia,East Hararge,Kombolicha,87,86,2,175
Hamle,11th,2010,Oromia,East Hararge,Gole Oda,20,88,90,198
Megabit,7th,2010,Oromia,West Arsi,Kofele,20,99,35,154
Yekatit,6th,2009,Oromia,Bale,Raitu,92,11,22,125
Tir,5th,2010,Oromia,East Wellega,Diga,80,44,70,194
Yekatit,6th,2009,Oromia,West Shewa,Tikur Enchini,50,47,97,194
Tir,5th,2011,Oromia,East Hararge,Fedis,54,63,40,157
Tahesas,4th,2011,Oromia,Dukem Town,Dukem Town,41,79,42,162
Teqemt,2nd,2011,Oromia,Qeleme Wellega,Jimma Horo,87,92,86,265
Sene,10th,2009,Oromia,East Hararge,Deder Town,8,80,80,168
Ginbot,9th,2010,Oromia,Jimma,Gera,71,15,26,112
Teqemt,2nd,2010,Oromia,West Guji,Bule Hora Toun,78,97,30,205
Sene,10th,2010,Oromia,East Wellega,Sasiga,73,90,57,220
Yekatit,6th,2009,Oromia,Qeleme Wellega,Jimma Horo,31,39,59,129
Miyazia,8th,2009,Oromia,Arsi,Guna,68,65,91,224
Miyazia,8th,2011,Oromia,Jimma,Setema,97,50,77,224
Tir,5th,2010,Oromia,Arsi,Amigna,15,16,59,90
Ginbot,9th,2010,Oromia,East Hararge,Garemuleta Hospital,64,16,39,119
Miyazia,8th,2009,Oromia,Buno Bedele,Bedele Zuriya,80,21,52,153
Yekatit,6th,2010,Oromia,Buno Bedele,Dapho Hana,92,98,68,258
Nehase,12th,2010,Oromia,South West Shewa,Tulu Bolo Hospital,44,98,97,239
Tir,5th,2011,Oromia,East Hararge,Garemuleta Hospital,8,58,34,100
Sene,10th,2009,Oromia,Bale,Delo Mena,53,62,97,212
Tir,5th,2010,Oromia,West Arsi,Kofele,67,67,58,192
Tahesas,4th,2011,Oromia,East Hararge,Goro Gutu,16,81,58,155
Ginbot,9th,2011,Oromia,Finfine Zuria,Sebeta Awas,33,95,86,214
Hedar,3rd,2011,Oromia,Horo Gudru Wellega,Abe Dengoro,73,81,87,241
Yekatit,6th,2009,Oromia,East Hararge,Meta,43,23,45,111
Ginbot,9th,2011,Oromia,West Wellega,Gimbi Adventist Hospital,71,96,2,169
Hedar,3rd,2011,Oromia,East Wellega,Wayu Tuqa,99,15,89,203
Tir,5th,2010,Oromia,West Arsi,Arsi Negele Rural,58,8,29,95
Sene,10th,2010,Oromia,West Wellega,Guliso,47,63,44,154
Sene,10th,2009,Oromia,Arsi,Deksis,1,1,23,25
Teqemt,2nd,2011,Oromia,Borena,Teltele,48,20,0,68
Ginbot,9th,2010,Oromia,Guji,Negele Town,61,97,70,228
Yekatit,6th,2011,Oromia,Jimma,Mancho,15,38,17,70
Tahesas,4th,2011,Oromia,Buno Bedele,Bedele Town,42,61,71,174
Nehase,12th,2010,Oromia,West Wellega,Nejo Town,39,9,32,80
Miyazia,8th,2010,Oromia,West Guji,Kercha Hospital,10,51,0,61
Meskerem,1st,2010,Oromia,Arsi,Digeluna Tijo,58,15,11,84
Tahesas,4th,2010,Oromia,West Shewa,Chelia,41,15,62,118
Ginbot,9th,2009,Oromia,Adama Special Town,Adama Town,73,3,11,87
Ginbot,9th,2010,Oromia,Guji,Dima,26,84,26,136
Megabit,7th,2009,Oromia,Guji,Shakiso Town,32,36,89,157
Nehase,12th,2009,Oromia,East Hararge,Aweday Town,13,28,75,116
Tir,5th,2010,Oromia,West Shewa,Ginde Beret,67,13,68,148
Megabit,7th,2009,Oromia,Guji,Dima,77,31,74,182
Yekatit,6th,2010,Oromia,West Wellega,Mendi Hospital,87,82,12,181
Tir,5th,2010,Oromia,East Hararge,Bisidimo Hospital,76,80,31,187
Ginbot,9th,2011,Oromia,East Wellega,Haro Limu,95,11,6,112
Hedar,3rd,2010,Oromia,Jimma,Sigmo,58,81,85,224
Tir,5th,2009,Oromia,Qeleme Wellega,Seyo,98,19,81,198
Tir,5th,2010,Oromia,East Wellega,Sibu Sire,84,38,8,130
Sene,10th,2009,Oromia,East Shewa,Lomme,62,73,60,195
Nehase,12th,2010,Oromia,West Arsi,Loke Hada Hospital,97,17,54,168
Tir,5th,2009,Oromia,East Hararge,Deder,77,73,67,217
Tir,5th,2009,Oromia,North Shewa,Debre Libanos,0,96,90,186
Tahesas,4th,2011,Oromia,Bale,Arena Buluq,79,60,33,172
Ginbot,9th,2010,Oromia,East Hararge,Kombolicha,89,6,0,95
Sene,10th,2009,Oromia,Ilu Aba Bora,Bure,2,84,9,95
Tir,5th,2011,Oromia,Bale,Agarfa,84,37,89,210
Tir,5th,2011,Oromia,Arsi,Jeju,1,44,65,110
Ginbot,9th,2011,Oromia,East Hararge,Haromaya Hospital,92,4,47,143
Tir,5th,2011,Oromia,Gelan Town,Gelan Town,64,47,74,185
Hedar,3rd,2010,Oromia,East Shewa,Gimbichu,13,94,78,185
Tahesas,4th,2010,Oromia,Bale,Goro,58,13,25,96
Sene,10th,2009,Oromia,West Shewa,Bako Tibe,54,84,70,208
Meskerem,1st,2010,Oromia,Borena,Gomole,91,35,62,188
Hamle,11th,2010,Oromia,West Hararge,Chiro Town,41,36,40,117
Hamle,11th,2009,Oromia,East Hararge,Chelenko Hospital,16,40,1,57
Hamle,11th,2009,Oromia,Arsi,Bale Gesgara,25,86,96,207
Meskerem,1st,2011,Oromia,East Hararge,Babile Woreda,80,6,9,95
Teqemt,2nd,2011,Oromia,West Shewa,Liban Jawi,67,29,28,124
Tahesas,4th,2011,Oromia,West Shewa,Chelia,49,14,76,139
Hedar,3rd,2010,Oromia,East Hararge,Garemuleta Hospital,16,1,58,75
Ginbot,9th,2011,Oromia,West Wellega,Lalo Asabi,93,79,62,234
Sene,10th,2009,Oromia,Sebeta Town,Sebeta Town,63,77,12,152
Megabit,7th,2011,Oromia,North Shewa,Dera,68,53,51,172
Ginbot,9th,2011,Oromia,North Shewa,Kimbibit,75,0,56,131
Ginbot,9th,2010,Oromia,Horo Gudru Wellega,Abay Chomen,72,68,60,200
Tahesas,4th,2010,Oromia,Lege Dadi Lege Tafo Town,Lege Dadi Lege Tafo Town,68,10,90,168
Meskerem,1st,2011,Oromia,Jimma,Mancho,62,84,6,152
Yekatit,6th,2010,Oromia,Bale,Goro,12,67,86,165
Yekatit,6th,2011,Oromia,Holeta Town,Holeta Town,77,17,57,151
Hamle,11th,2010,Oromia,East Shewa,Liben,79,5,96,180
Yekatit,6th,2010,Oromia,Borena,El Way,4,94,93,191
Tir,5th,2010,Oromia,West Arsi,Adaba,69,15,32,116
Nehase,12th,2010,Oromia,Buno Bedele,Dapho Hana,13,51,89,153
Teqemt,2nd,2011,Oromia,Adama Special Town,Adama Town,15,93,10,118
Ginbot,9th,2009,Oromia,Jimma,Mana,43,14,72,129
Ginbot,9th,2009,Oromia,South West Shewa,Becho,14,47,71,132
Miyazia,8th,2009,Oromia,East Hararge,Jarso,90,44,0,134
Miyazia,8th,2009,Oromia,West Arsi,Wondo,30,9,16,55
Sene,10th,2010,Oromia,West Guji,Kercha Hospital,51,20,18,89
Hedar,3rd,2010,Oromia,Horo Gudru Wellega,Shambu Hospital,30,43,42,115
Tir,5th,2011,Oromia,North Shewa,Dera Hospital,7,62,23,92
Meskerem,1st,2010,Oromia,North Shewa,Were Jarso,78,31,73,182
Miyazia,8th,2011,Oromia,South West Shewa,St.Luke Hospital,93,39,11,143
Ginbot,9th,2010,Oromia,West Shewa,Gindeberet Hospital,71,81,98,250
Tahesas,4th,2011,Oromia,Jimma,B/Tolyi,49,35,19,103
Nehase,12th,2009,Oromia,West Shewa,Jibat,58,33,57,148
Ginbot,9th,2011,Oromia,Horo Gudru Wellega,Abay Chomen,13,6,32,51
Tir,5th,2011,Oromia,East Wellega,Jimma Arjo,5,20,42,67
Tahesas,4th,2010,Oromia,East Wellega,Diga,70,81,67,218
Teqemt,2nd,2011,Oromia,Finfine Zuria,Akaki,91,78,21,190
Tir,5th,2009,Oromia,Buno Bedele,Bedele Zuriya,57,0,2,59
Ginbot,9th,2009,Oromia,East Shewa,Lomme,62,66,94,222
Meskerem,1st,2010,Oromia,East Wellega,Jimma Arjo,60,44,81,185
Tahesas,4th,2010,Oromia,Arsi,Zeway Dugda,83,65,69,217
Sene,10th,2009,Oromia,East Wellega,Limu,17,16,88,121
Tahesas,4th,2010,Oromia,West Shewa,Inchini Hospital,12,87,76,175
Meskerem,1st,2010,Oromia,Buno Bedele,Chora,61,53,85,199
Hedar,3rd,2010,Oromia,East Shewa,Matahara,70,82,37,189
Meskerem,1st,2010,Oromia,West Wellega,Yubdo,25,4,91,120
Teqemt,2nd,2010,Oromia,Arsi,Merti,42,8,79,129
Meskerem,1st,2011,Oromia,West Wellega,Nejo Rural,28,85,87,200
Yekatit,6th,2011,Oromia,East Hararge,Fedis,69,90,68,227
Sene,10th,2011,Oromia,West Wellega,Gimbi Adventist Hospital,47,84,31,162
Teqemt,2nd,2010,Oromia,Assela Town,Assela Town,43,13,57,113
Nehase,12th,2010,Oromia,West Shewa,Dendi,58,64,4,126
Teqemt,2nd,2011,Oromia,Finfine Zuria,Sululta Town,26,91,32,149
Nehase,12th,2010,Oromia,Jimma,Agaro Hospital,38,83,80,201
Hedar,3rd,2011,Oromia,West Shewa,Dendi,34,35,86,155
Tahesas,4th,2011,Oromia,West Wellega,Gimbi,22,27,44,93
Megabit,7th,2011,Oromia,West Arsi,Nensebo,79,62,6,147
Hamle,11th,2009,Oromia,Dukem Town,Dukem Town,60,76,28,164
Miyazia,8th,2011,Oromia,Borena,Dilo,5,46,99,150
Yekatit,6th,2011,Oromia,East Hararge,Chelenko Hospital,21,61,70,152
Tir,5th,2011,Oromia,Bale,Raitu,38,76,50,164
Hamle,11th,2009,Oromia,Jimma Spe Town,Jimma Spe Town,42,78,88,208
Nehase,12th,2010,Oromia,Arsi,Jeju,38,73,72,183
Meskerem,1st,2010,Oromia,North Shewa,Degem,18,32,63,113
Megabit,7th,2010,Oromia,West Hararge,Burka Dimtu,94,48,15,157
Megabit,7th,2009,Oromia,Arsi,Guna,66,22,85,173
Megabit,7th,2010,Oromia,Ilu Aba Bora,Algesachi,63,72,83,218
Tir,5th,2010,Oromia,Bale,Raitu,75,21,21,117
Ginbot,9th,2010,Oromia,West Wellega,Gimbi Adventist Hospital,43,29,31,103
Miyazia,8th,2010,Oromia,West Guji,Biebirsa Kojowa,93,87,18,198
Megabit,7th,2010,Oromia,Jimma,Limu Kosa,6,95,98,199
Hamle,11th,2010,Oromia,West Arsi,Dodola  Hospital,28,17,55,100
Hamle,11th,2009,Oromia,Jimma,Limu Hospital,13,49,59,121
Hamle,11th,2010,Oromia,West Hararge,Hawi Gudina,98,29,41,168
Ginbot,9th,2010,Oromia,West Hararge,Tulo,52,61,80,193
Sene,10th,2011,Oromia,South West Shewa,Tulu Bolo Hospital,78,3,15,96
Sene,10th,2011,Oromia,West Arsi,Shala,43,28,21,92
Megabit,7th,2011,Oromia,West Wellega,Guliso,16,55,88,159
Tir,5th,2011,Oromia,Bale,Gura Dhamole,56,95,6,157
Meskerem,1st,2011,Oromia,West Arsi,Arsi Negele Town,58,35,38,131
Yekatit,6th,2010,Oromia,West Shewa,Bako Tibe,29,39,60,128
Meskerem,1st,2010,Oromia,Bale,Ginir Town,75,13,14,102
Teqemt,2nd,2010,Oromia,Ilu Aba Bora,Bilonopa,20,65,53,138
Miyazia,8th,2011,Oromia,Ilu Aba Bora,Bilonopa,53,96,79,228
Yekatit,6th,2010,Oromia,Ilu Aba Bora,Metu Town,3,41,5,49
Teqemt,2nd,2011,Oromia,Ilu Aba Bora,Algesachi,83,6,68,157
Tir,5th,2010,Oromia,West Shewa,Jeldu,96,69,34,199
Megabit,7th,2009,Oromia,West Shewa,Nono,17,44,13,74
Nehase,12th,2010,Oromia,Horo Gudru Wellega,Abay Chomen,39,95,9,143
Nehase,12th,2009,Oromia,West Wellega,Mene Sibu,6,83,32,121
Tahesas,4th,2011,Oromia,Horo Gudru Wellega,Jarte Jardga,19,55,8,82
Hamle,11th,2010,Oromia,Jimma,Agaro,40,70,35,145
Tahesas,4th,2011,Oromia,Sululta Town,Sululta Town,92,32,34,158
Tir,5th,2009,Oromia,West Hararge,Habro,49,37,52,138
Nehase,12th,2009,Oromia,West Wellega,Nole Kaba,6,60,49,115
Yekatit,6th,2010,Oromia,Guji,Anna Sora,26,92,51,169
Megabit,7th,2009,Oromia,East Shewa,Adea,22,55,59,136
Yekatit,6th,2011,Oromia,East Wellega,Nunu Qumba,94,51,70,215
Yekatit,6th,2011,Oromia,Arsi,Jeju,48,97,76,221
Miyazia,8th,2010,Oromia,Arsi,Guna,3,64,74,141
Yekatit,6th,2009,Oromia,East Hararge,Meta,49,65,56,170
Nehase,12th,2010,Oromia,West Shewa,Metarobi,37,87,91,215
Tir,5th,2011,Oromia,East Shewa,Bora,18,87,95,200
Teqemt,2nd,2011,Oromia,Bale,Berbere,33,27,34,94
Megabit,7th,2011,Oromia,West Hararge,Anchar,5,73,3,81
Yekatit,6th,2009,Oromia,North Shewa,Kuyu Hospital,98,19,88,205
Tir,5th,2010,Oromia,Jimma,Shabe,3,75,85,163
Megabit,7th,2010,Oromia,West Wellega,Gimbi Adventist Hospital,10,8,59,77
Ginbot,9th,2010,Oromia,Bale,Dawe Qachen,0,71,52,123
Hamle,11th,2010,Oromia,Finfine Zuria,Akaki,84,38,12,134
Hamle,11th,2009,Oromia,Guji,Liben,92,4,68,164
Miyazia,8th,2011,Oromia,East Hararge,Haromaya Rural,17,65,63,145
Teqemt,2nd,2010,Oromia,West Arsi,Dodola Rural,69,29,87,185
Tahesas,4th,2010,Oromia,North Shewa,Yaya Gulele,45,61,59,165
Hamle,11th,2009,Oromia,Guji,Adola Town,37,48,31,116
Megabit,7th,2011,Oromia,West Guji,Kercha,28,28,55,111
Meskerem,1st,2010,Oromia,Bale,Dinsho,72,7,26,105
Teqemt,2nd,2010,Oromia,East Wellega,Sibu Sire,33,98,69,200
Tir,5th,2011,Oromia,East Wellega,Gudeyabila,38,52,70,160
Tir,5th,2010,Oromia,East Wellega,Sibu Sire,23,13,81,117
Nehase,12th,2009,Oromia,West Guji,Hanbala,91,18,7,116
Miyazia,8th,2010,Oromia,Arsi,Enkelo Wabe,14,27,2,43
Tahesas,4th,2011,Oromia,Guji,Wadara,43,97,9,149
Hedar,3rd,2011,Oromia,Guji,Adola Reda,90,92,35,217
Hedar,3rd,2011,Oromia,West Wellega,Gimbi Adventist Hospital,70,37,64,171
Tir,5th,2010,Oromia,Jimma,Nono Benja,57,95,34,186
Miyazia,8th,2009,Oromia,West Arsi,Kofele,73,8,55,136
Teqemt,2nd,2010,Oromia,Arsi,Bekoji Town,91,18,37,146
Teqemt,2nd,2011,Oromia,Arsi,Sire,95,98,42,235
Yekatit,6th,2009,Oromia,Ilu Aba Bora,Hurumu,70,84,96,250
Megabit,7th,2009,Oromia,West Guji,Bule Hora,41,24,32,97
Teqemt,2nd,2010,Oromia,East Wellega,Guto Gida,58,33,60,151
Sene,10th,2009,Oromia,Ilu Aba Bora,Nono Sele,49,38,64,151
Tir,5th,2011,Oromia,South West Shewa,Becho,75,68,66,209
Miyazia,8th,2010,Oromia,South West Shewa,Sodo Dac'Ha,86,7,63,156
Hedar,3rd,2010,Oromia,Arsi,Tena,7,4,18,29
Miyazia,8th,2011,Oromia,Buno Bedele,Meko,90,61,38,189
Hedar,3rd,2011,Oromia,Guji,Aga Wayyu,2,82,85,169
Yekatit,6th,2009,Oromia,Ilu Aba Bora,Doreni,8,40,57,105
Tir,5th,2009,Oromia,East Wellega,Limu,61,11,97,169
Ginbot,9th,2011,Oromia,Arsi,Shenan Kolu,24,75,78,177
Nehase,12th,2009,Oromia,Arsi,Tiyo,17,26,71,114
Tir,5th,2009,Oromia,West Guji,Mkelka Soda,94,59,74,227
Meskerem,1st,2010,Oromia,West Shewa,Gedo Hospital,85,60,88,233
Sene,10th,2009,Oromia,West Shewa,Ilu Galan,22,4,80,106
Yekatit,6th,2010,Oromia,West Shewa,Ginde Beret,57,32,91,180
Sene,10th,2010,Oromia,Horo Gudru Wellega,Shambu Hospital,4,96,76,176
Teqemt,2nd,2010,Oromia,Arsi,Enkelo Wabe,5,85,6,96
Tir,5th,2009,Oromia,West Wellega,Mene Sibu,22,72,11,105
Meskerem,1st,2010,Oromia,Jimma,Shabe,58,12,13,83
Meskerem,1st,2011,Oromia,North Shewa,Kuyu Hospital,84,6,91,181
Tahesas,4th,2011,Oromia,Qeleme Wellega,Dambi Dollo,44,23,26,93
Megabit,7th,2011,Oromia,Guji,Adola Reda,38,8,13,59
Ginbot,9th,2011,Oromia,Arsi,Amigna,54,65,38,157
Ginbot,9th,2009,Oromia,West Shewa,Jibat,26,17,30,73
Tahesas,4th,2011,Oromia,West Wellega,Lalo Asabi,24,62,43,129
Tahesas,4th,2010,Oromia,West Wellega,Ayira,70,32,73,175
Hedar,3rd,2011,Oromia,Guji,Aga Wayyu,0,79,24,103
Hedar,3rd,2010,Oromia,West Shewa,Ambo,59,64,22,145
Megabit,7th,2009,Oromia,Horo Gudru Wellega,Jima Geneti,29,83,64,176
Hamle,11th,2010,Oromia,West Guji,Bule Hora Toun,73,80,20,173
Megabit,7th,2009,Oromia,Nekemte Town,Nekemte Town,57,94,65,216
Sene,10th,2009,Oromia,East Hararge,Haromaya Rural,68,20,51,139
Miyazia,8th,2010,Oromia,East Hararge,Haromaya Rural,52,98,15,165
Ginbot,9th,2010,Oromia,Assela Town,Assela Town,89,71,21,181
Nehase,12th,2010,Oromia,Bale,Gura Dhamole,48,69,91,208
Hamle,11th,2010,Oromia,Horo Gudru Wellega,Abe Dengoro,55,42,42,139
Tir,5th,2011,Oromia,West Shewa,Ambo University  Hosp,80,46,96,222
Sene,10th,2011,Oromia,Arsi,Tiyo,92,87,46,225
Megabit,7th,2009,Oromia,Buno Bedele,Dedesa,30,79,4,113
Tahesas,4th,2011,Oromia,West Wellega,Qiltu Kara,12,79,35,126
Tir,5th,2011,Oromia,North Shewa,Kimbibit,45,38,59,142
Sene,10th,2010,Oromia,South West Shewa,Sodo Dac'Ha,73,27,30,130
Nehase,12th,2010,Oromia,Borena,Guchi,29,78,55,162
Meskerem,1st,2010,Oromia,Guji,Goro Dola,73,15,55,143
Meskerem,1st,2010,Oromia,Qeleme Wellega,Seyo,92,44,31,167
Hedar,3rd,2011,Oromia,Borena,Dhas,30,43,8,81
Teqemt,2nd,2010,Oromia,Horo Gudru Wellega,Abe Dengoro,72,29,33,134
Sene,10th,2010,Oromia,West Guji,Bule Hora,16,34,10,60
Miyazia,8th,2010,Oromia,West Wellega,Lalo Asabi,29,82,53,164
Yekatit,6th,2009,Oromia,Bale,Dawe Qachen,23,99,86,208
Megabit,7th,2010,Oromia,Bale,Goro,59,94,13,166
Megabit,7th,2011,Oromia,Horo Gudru Wellega,Abay Chomen,82,15,9,106
Sene,10th,2009,Oromia,Buno Bedele,Bedele Zuriya,76,29,11,116
Ginbot,9th,2011,Oromia,West Hararge,Hawi Gudina,63,85,92,240
Megabit,7th,2010,Oromia,North Shewa,Jido,4,52,7,63
Teqemt,2nd,2011,Oromia,East Shewa,Lomme,8,32,84,124
Tir,5th,2010,Oromia,Horo Gudru Wellega,Chomen Guduru,0,68,71,139
Teqemt,2nd,2010,Oromia,Buno Bedele,Bedele Zuriya,8,2,48,58
Tir,5th,2010,Oromia,East Hararge,Chelenko Hospital,6,74,58,138
Tahesas,4th,2010,Oromia,Borena,Gomole,12,59,78,149
Sene,10th,2009,Oromia,West Guji,Hanbala,59,35,0,94
Sene,10th,2009,Oromia,Bale,Robe Town,18,25,98,141
Sene,10th,2011,Oromia,Bale,Ginir,90,22,71,183
Megabit,7th,2009,Oromia,East Hararge,Aweday Town,56,54,93,203
Ginbot,9th,2011,Oromia,Buno Bedele,Boricha,1,8,46,55
Tir,5th,2010,Oromia,West Arsi,Hebal Arsi,84,67,80,231
Tahesas,4th,2011,Oromia,Borena,Dilo,13,81,84,178
Nehase,12th,2010,Oromia,Buno Bedele,Bedele Town,72,85,84,241
Tahesas,4th,2011,Oromia,West Hararge,Gelemso Hospital,63,3,52,118
Teqemt,2nd,2011,Oromia,South West Shewa,Ameya Hospital,92,11,44,147
Megabit,7th,2010,Oromia,Borena,Moyale Hospital,79,44,34,157
Megabit,7th,2010,Oromia,North Shewa,Were Jarso,45,15,43,103
Hamle,11th,2009,Oromia,Borena,Yabelo Hospital,66,56,4,126
Tahesas,4th,2010,Oromia,Jimma,Setema,30,6,55,91
Teqemt,2nd,2010,Oromia,Qeleme Wellega,Sedan Chanka,84,0,27,111
Hamle,11th,2010,Oromia,Buno Bedele,Diga,79,86,32,197
Teqemt,2nd,2011,Oromia,West Arsi,Kokosa,64,7,33,104
Hedar,3rd,2010,Oromia,Guji,Adola Town,66,66,5,137
Meskerem,1st,2010,Oromia,West Arsi,Dodola Town,71,86,10,167
Meskerem,1st,2010,Oromia,South West Shewa,Tulu Bolo Hospital,66,21,10,97
Meskerem,1st,2011,Oromia,Borena,Dilo,8,44,21,73
Megabit,7th,2010,Oromia,East Wellega,Guto Gida,7,13,42,62
Sene,10th,2011,Oromia,West Wellega,Begi Hospital,65,87,9,161
Hedar,3rd,2011,Oromia,Borena,Guchi,23,12,17,52
Teqemt,2nd,2010,Oromia,West Hararge,Daro Lebu,25,18,46,89
Nehase,12th,2009,Oromia,Arsi,Aseko,24,16,92,132
Tahesas,4th,2011,Oromia,West Wellega,Genji,73,54,4,131
Ginbot,9th,2011,Oromia,North Shewa,Dera,61,2,55,118
Hedar,3rd,2010,Oromia,South West Shewa,Becho,95,55,72,222
Meskerem,1st,2011,Oromia,Ambo Town,Ambo Town,65,39,47,151
Hedar,3rd,2010,Oromia,West Guji,Bule Hora,6,94,57,157
Megabit,7th,2011,Oromia,West Guji,Kercha,97,93,29,219
Yekatit,6th,2009,Oromia,West Hararge,Daro Lebu,34,48,71,153
Hedar,3rd,2010,Oromia,East Hararge,Bedeno,6,0,65,71
Nehase,12th,2010,Oromia,Bale,Ginir Town,2,2,88,92
Ginbot,9th,2011,Oromia,Borena,Yabelo,25,1,49,75
Tahesas,4th,2010,Oromia,West Shewa,Inchini Hospital,38,26,2,66
Sene,10th,2009,Oromia,Dukem Town,Dukem Town,23,73,14,110
Miyazia,8th,2009,Oromia,West Shewa,Ambo,68,43,83,194
Meskerem,1st,2011,Oromia,West Shewa,Jeldu,86,71,84,241
Tahesas,4th,2011,Oromia,Jimma,Agaro Hospital,30,30,18,78
Sene,10th,2009,Oromia,Finfine Zuria,Sandefa,69,1,82,152
Tir,5th,2010,Oromia,East Hararge,Chelenko Hospital,3,4,87,94
Miyazia,8th,2010,Oromia,West Shewa,Abuna Gindeberet,56,41,56,153
Yekatit,6th,2009,Oromia,Buno Bedele,Meko,70,2,84,156
Tir,5th,2009,Oromia,East Shewa,Bora,77,16,57,150
Yekatit,6th,2011,Oromia,West Shewa,Gojo Hospital,52,10,43,105
Ginbot,9th,2010,Oromia,West Arsi,Shashemene Rural,21,29,23,73
Hamle,11th,2010,Oromia,West Guji,Hanbala,69,8,80,157
Tir,5th,2011,Oromia,Qeleme Wellega,Sedan Chanka,42,53,74,169
Megabit,7th,2011,Oromia,Arsi,Deksis,61,35,23,119
Ginbot,9th,2009,Oromia,Ilu Aba Bora,Bilonopa,79,39,37,155
Hedar,3rd,2011,Oromia,West Wellega,Nejo Hospital,54,11,80,145
Nehase,12th,2010,Oromia,Buno Bedele,Dedesa,32,38,91,161
Megabit,7th,2011,Oromia,Horo Gudru Wellega,Shambu Town,34,85,90,209
Tahesas,4th,2011,Oromia,Bale,Arena Buluq,24,63,10,97
Meskerem,1st,2011,Oromia,Adama Special Town,Adama Town,68,31,65,164
Yekatit,6th,2009,Oromia,West Wellega,Kundala,19,13,85,117
Ginbot,9th,2009,Oromia,Ilu Aba Bora,Nono Sele,1,86,36,123
Sene,10th,2011,Oromia,West Guji,Kercha Hospital,2,22,51,75
Megabit,7th,2011,Oromia,Arsi,Dodota,22,25,48,95
Ginbot,9th,2010,Oromia,Robe Town,Robe Town,8,17,47,72
Hamle,11th,2010,Oromia,East Hararge,Goro Gutu,37,28,72,137
Sene,10th,2010,Oromia,East Shewa,Fentale,67,26,60,153
Megabit,7th,2011,Oromia,Borena,Dhas,43,56,7,106
Hamle,11th,2009,Oromia,Borena,Dhas,33,12,75,120
Yekatit,6th,2009,Oromia,North Shewa,Fiche Hospital,76,51,24,151
Megabit,7th,2010,Oromia,Jimma,Limu Hospital,14,7,55,76
Nehase,12th,2010,Oromia,Ilu Aba Bora,Didu,87,4,33,124
Tahesas,4th,2010,Oromia,Modjo Town,Modjo Town,57,33,37,127
Teqemt,2nd,2010,Oromia,Ilu Aba Bora,Yayu,65,7,8,80
Megabit,7th,2009,Oromia,West Shewa,Ilu Galan,69,46,42,157
Miyazia,8th,2009,Oromia,North Shewa,Kimbibit,69,64,1,134
Ginbot,9th,2011,Oromia,North Shewa,Girar Jarso,6,50,15,71
Ginbot,9th,2011,Oromia,West Arsi,Wondo,18,37,31,86
Tahesas,4th,2011,Oromia,West Wellega,Kundala,88,90,5,183
Teqemt,2nd,2010,Oromia,Borena,Gomole,95,72,15,182
Miyazia,8th,2011,Oromia,West Shewa,Codi,41,60,98,199
Sene,10th,2009,Oromia,West Shewa,Gedo Hospital,87,26,91,204
Meskerem,1st,2010,Oromia,Borena,Dubluk,57,59,37,153
Hamle,11th,2010,Oromia,West Wellega,Boji Cheqorsa,91,79,0,170
Tahesas,4th,2011,Oromia,Ilu Aba Bora,Nono Sele,84,1,0,85
Hedar,3rd,2011,Oromia,Horo Gudru Wellega,Chomen Guduru,49,4,44,97
Meskerem,1st,2011,Oromia,Qeleme Wellega,Yemalogi Wolel,55,33,52,140
Sene,10th,2011,Oromia,Ilu Aba Bora,Yayu,20,56,37,113
Hedar,3rd,2010,Oromia,Guji,Negele Town,48,53,12,113
Ginbot,9th,2011,Oromia,West Guji,Bule Hora,69,73,78,220
Megabit,7th,2011,Oromia,Buno Bedele,Dapho Hana,83,86,68,237
Meskerem,1st,2010,Oromia,Ilu Aba Bora,Nono Sele,69,57,64,190
Hedar,3rd,2010,Oromia,Buno Bedele,Bedele Zuriya,13,45,83,141
Sene,10th,2009,Oromia,Ilu Aba Bora,Ale,50,40,54,144
Miyazia,8th,2010,Oromia,East Hararge,Goro Gutu,68,76,11,155
Hedar,3rd,2010,Oromia,Arsi,Shenan Kolu,91,99,16,206
Meskerem,1st,2011,Oromia,Arsi,Tena,70,85,61,216
Hedar,3rd,2011,Oromia,Finfine Zuria,Mullo,39,47,16,102
Nehase,12th,2010,Oromia,Jimma Spe Town,Jimma Spe Town,79,40,56,175
Megabit,7th,2009,Oromia,East Wellega,Gudeyabila,76,18,9,103
Miyazia,8th,2011,Oromia,West Wellega,Nejo Rural,13,74,60,147
Sene,10th,2010,Oromia,East Shewa,Olanciti Hospital,72,10,68,150
Sene,10th,2011,Oromia,South West Shewa,Ameya Hospital,33,52,26,111
Megabit,7th,2011,Oromia,West Shewa,Dano,48,21,94,163
Miyazia,8th,2009,Oromia,Qeleme Wellega,Hawa Gelan,29,47,55,131
Hamle,11th,2010,Oromia,East Wellega,Gudeyabila,62,88,2,152
Yekatit,6th,2011,Oromia,Bale,Dawe Qachen,50,85,1,136
Tir,5th,2009,Oromia,West Shewa,Bako Tibe,95,25,67,187
Meskerem,1st,2010,Oromia,East Wellega,Sasiga,71,25,33,129
Tir,5th,2010,Oromia,West Hararge,Oda Bultum,41,17,3,61
Yekatit,6th,2011,Oromia,East Shewa,Batu,56,67,63,186
Nehase,12th,2009,Oromia,Arsi,Deksis,69,29,66,164
Ginbot,9th,2009,Oromia,West Shewa,Abuna Gindeberet,53,74,61,188
Tahesas,4th,2010,Oromia,West Guji,Hanbala,61,33,68,162
Megabit,7th,2010,Oromia,West Shewa,Jibat,31,62,63,156
Tir,5th,2011,Oromia,Guji,Hambela Wamena,24,66,20,110
Miyazia,8th,2009,Oromia,Bale,Goro,89,68,1,158
Sene,10th,2009,Oromia,Arsi,Jeju,78,22,33,133
Ginbot,9th,2010,Oromia,Borena,Yabelo Rural,60,97,4,161
Sene,10th,2010,Oromia,Jimma,Agaro,81,9,65,155
Sene,10th,2009,Oromia,Ilu Aba Bora,Bure,82,35,9,126
Miyazia,8th,2010,Oromia,Bale,Seweyna,22,78,19,119
Nehase,12th,2009,Oromia,West Wellega,Gimbi Rural,4,35,78,117
Teqemt,2nd,2010,Oromia,East Wellega,Sibu Sire,50,56,5,111
Tahesas,4th,2011,Oromia,Qeleme Wellega,Dale Sedi,60,72,53,185
Teqemt,2nd,2011,Oromia,East Wellega,Wayu Tuqa,65,36,73,174
Hedar,3rd,2010,Oromia,Buno Bedele,Chora,64,96,36,196
Yekatit,6th,2011,Oromia,Bale,Dawe Serar,52,34,74,160
Nehase,12th,2009,Oromia,Ilu Aba Bora,Halu,20,79,93,192
Nehase,12th,2009,Oromia,East Hararge,Fedis,83,90,54,227
Sene,10th,2011,Oromia,Borena,Gomole,9,27,12,48
Megabit,7th,2009,Oromia,West Shewa,Tibe Kutaye,23,50,10,83
Tir,5th,2009,Oromia,East Hararge,Deder,87,64,10,161
Tir,5th,2010,Oromia,West Wellega,Seyo Nole,24,1,43,68
Tahesas,4th,2010,Oromia,Guji,Uraga,86,87,40,213
Miyazia,8th,2009,Oromia,Bale,Dinsho,98,41,21,160
Megabit,7th,2009,Oromia,Qeleme Wellega,Dambi Dolo Hospital,61,53,0,114
Meskerem,1st,2011,Oromia,West Shewa,Adea Berga,25,70,78,173
Miyazia,8th,2011,Oromia,West Wellega,Lalo Asabi,15,53,11,79
Ginbot,9th,2011,Oromia,Jimma,Seka Chekorsa,77,20,69,166
Megabit,7th,2009,Oromia,Borena,Moyale Hospital,25,12,11,48
Sene,10th,2009,Oromia,East Hararge,Jarso,57,54,85,196
Sene,10th,2011,Oromia,West Arsi,Hebal Arsi,91,25,62,178
Miyazia,8th,2011,Oromia,North Shewa,Jido,31,89,57,177
Tir,5th,2009,Oromia,West Hararge,Chiro Zuriya,51,57,34,142
Teqemt,2nd,2011,Oromia,East Hararge,Meyu Muleke,30,96,72,198
Yekatit,6th,2009,Oromia,East Hararge,Fedis,3,65,74,142
Tir,5th,2011,Oromia,West Shewa,Meta Waliqite,11,51,52,114
Megabit,7th,2009,Oromia,Jimma,Seka Chekorsa,22,11,67,100
Ginbot,9th,2011,Oromia,Qeleme Wellega,Dambi Dollo,40,69,72,181
Miyazia,8th,2011,Oromia,West Arsi,Kokosa  Hospital,61,85,79,225
Miyazia,8th,2009,Oromia,East Wellega,Boneya Bushe,48,83,87,218
Yekatit,6th,2010,Oromia,Buno Bedele,Bedele Town,52,45,8,105
Ginbot,9th,2011,Oromia,East Shewa,Liben,19,80,55,154
Megabit,7th,2010,Oromia,Finfine Zuria,Berreh,92,36,97,225
Hedar,3rd,2011,Oromia,East Hararge,Bedeno,29,74,72,175
Nehase,12th,2009,Oromia,West Shewa,Ambo,98,78,86,262
Sene,10th,2010,Oromia,North Shewa,Hidabu Abote,29,96,20,145
Ginbot,9th,2010,Oromia,West Arsi,Bishan Guracha Town,36,88,62,186
Hedar,3rd,2011,Oromia,Borena,Meyo,26,74,51,151
Miyazia,8th,2011,Oromia,West Wellega,Ayira,29,68,74,171
Yekatit,6th,2009,Oromia,East Hararge,Jarso,98,76,78,252
Ginbot,9th,2010,Oromia,Jimma,Nono Benja,2,33,64,99
Miyazia,8th,2010,Oromia,East Hararge,Kersa Eh,41,59,80,180
Tahesas,4th,2011,Oromia,Jimma,Limu Seka,7,29,79,115
Tahesas,4th,2010,Oromia,West Arsi,Kofele,68,11,91,170
Ginbot,9th,2010,Oromia,West Hararge,Habro,36,7,84,127
Hamle,11th,2010,Oromia,Arsi,Robe,10,76,60,146
Ginbot,9th,2011,Oromia,West Shewa,Elifata,77,32,0,109
Hamle,11th,2010,Oromia,South West Shewa,Dawo,66,85,38,189
Nehase,12th,2009,Oromia,East Hararge,Kersa Eh,59,81,23,163
Yekatit,6th,2010,Oromia,North Shewa,Dera Hospital,38,9,16,63
Ginbot,9th,2011,Oromia,East Hararge,Babile Woreda,66,59,73,198
Ginbot,9th,2009,Oromia,Qeleme Wellega,Seyo,56,34,90,180
Meskerem,1st,2011,Oromia,West Shewa,Ejerie,47,98,45,190
Nehase,12th,2010,Oromia,Horo Gudru Wellega,Shambu Town,56,15,56,127
Ginbot,9th,2011,Oromia,West Wellega,Lata Sibu,43,70,43,156
Ginbot,9th,2011,Oromia,Finfine Zuria,Mullo,54,60,14,128
Miyazia,8th,2009,Oromia,Borena,Dubluk,13,32,86,131
Sene,10th,2010,Oromia,Bale,Meda Welabu,39,22,77,138
Nehase,12th,2010,Oromia,East Shewa,Batu,32,10,57,99
Ginbot,9th,2011,Oromia,North Shewa,Kuyu Hospital,50,70,33,153
Yekatit,6th,2011,Oromia,West Shewa,Ilu Galan,29,35,35,99
Meskerem,1st,2010,Oromia,East Wellega,Nunu Qumba,78,43,91,212
Hamle,11th,2009,Oromia,West Hararge,Tulo,54,69,98,221
Nehase,12th,2009,Oromia,West Arsi,Dodola Rural,59,15,21,95
Miyazia,8th,2009,Oromia,North Shewa,Wuchale,76,31,43,150
Tahesas,4th,2011,Oromia,West Wellega,Nejo Rural,52,10,57,119
Hedar,3rd,2010,Oromia,East Wellega,Guto Gida,91,11,3,105
Tir,5th,2011,Oromia,East Wellega,Wayu Tuqa,1,13,64,78
Teqemt,2nd,2010,Oromia,East Wellega,Wama Hagelo,72,51,69,192
Ginbot,9th,2011,Oromia,Qeleme Wellega,Hawa Gelan Hosp,83,52,44,179
Hedar,3rd,2011,Oromia,East Wellega,Jimma Arjo,6,59,2,67
Hedar,3rd,2011,Oromia,East Wellega,Gida Ayana,94,56,4,154
Sene,10th,2010,Oromia,South West Shewa,Bantu  Hospital,74,75,47,196
Hedar,3rd,2010,Oromia,South West Shewa,Kersana Malima,73,76,64,213
Meskerem,1st,2011,Oromia,Guji,Dima,29,90,56,175
Ginbot,9th,2011,Oromia,Bale,Seweyna,89,63,40,192
Tir,5th,2011,Oromia,West Wellega,Ayira,10,8,60,78
Nehase,12th,2010,Oromia,West Wellega,Lalo Asabi,42,39,82,163
Megabit,7th,2010,Oromia,Guji,Odo Shakiso,75,78,41,194
Nehase,12th,2009,Oromia,South West Shewa,Woliso Rural,97,7,77,181
Ginbot,9th,2011,Oromia,Bale,Raitu,49,87,2,138
Nehase,12th,2009,Oromia,Arsi,Jeju,40,13,60,113
Sene,10th,2010,Oromia,South West Shewa,Ameya,17,86,33,136
Ginbot,9th,2009,Oromia,East Wellega,Wama Hagelo,30,11,76,117
Megabit,7th,2009,Oromia,East Shewa,Batu,69,90,16,175
Yekatit,6th,2011,Oromia,Holeta Town,Holeta Town,26,90,70,186
Hamle,11th,2010,Oromia,North Shewa,Were Jarso,61,69,80,210
Sene,10th,2009,Oromia,Arsi,Limuna Bilbilo,84,80,7,171
Hedar,3rd,2010,Oromia,East Wellega,Diga,28,30,87,145
Megabit,7th,2009,Oromia,Arsi,Limuna Bilbilo,59,44,8,111
Ginbot,9th,2009,Oromia,South West Shewa,Woliso Town,30,6,38,74
Sene,10th,2011,Oromia,West Guji,Abaya,57,49,55,161
Teqemt,2nd,2010,Oromia,West Shewa,Gindeberet Hospital,73,63,5,141
Meskerem,1st,2010,Oromia,Arsi,Robe,4,14,11,29
Miyazia,8th,2010,Oromia,Jimma,B/Tolyi,28,35,76,139
Meskerem,1st,2011,Oromia,East Wellega,Guto Gida,34,10,81,125
Tir,5th,2009,Oromia,Arsi,Amigna,44,46,14,104
Nehase,12th,2010,Oromia,Borena,Dilo,56,96,53,205
Sene,10th,2010,Oromia,East Shewa,Adea,78,71,32,181
Tir,5th,2011,Oromia,West Wellega,Homa,52,86,70,208
Megabit,7th,2009,Oromia,Bale,Agarfa,31,16,48,95
Meskerem,1st,2011,Oromia,Robe Town,Robe Town,92,6,69,167
Tir,5th,2009,Oromia,Jimma,Gomma,25,29,14,68
Miyazia,8th,2011,Oromia,East Hararge,Meyu Muleke,84,7,38,129
Ginbot,9th,2011,Oromia,West Guji,Mkelka Soda,3,41,20,64
Hamle,11th,2009,Oromia,West Hararge,Habro,22,92,36,150
Miyazia,8th,2009,Oromia,East Shewa,Liben,42,72,42,156
Ginbot,9th,2010,Oromia,Arsi,Digeluna Tijo,9,48,43,100
Megabit,7th,2010,Oromia,Lege Dadi Lege Tafo Town,Lege Dadi Lege Tafo Town,94,52,11,157
Ginbot,9th,2010,Oromia,Buno Bedele,Bedele Town,9,61,46,116
Yekatit,6th,2011,Oromia,West Guji,Kercha,50,97,87,234
Sene,10th,2009,Oromia,West Arsi,Gambo Hospital,52,47,42,141
Yekatit,6th,2011,Oromia,Borena,Meyo,6,61,14,81
Megabit,7th,2009,Oromia,Guji,Dima,84,55,45,184
Ginbot,9th,2009,Oromia,Bale,Dawe Qachen,54,38,78,170
Ginbot,9th,2010,Oromia,Guji,Liben,10,52,86,148
Hedar,3rd,2010,Oromia,West Arsi,Kofele,18,46,72,136
Nehase,12th,2010,Oromia,Qeleme Wellega,Sedan Chanka,25,22,65,112
Nehase,12th,2010,Oromia,Ilu Aba Bora,Didu,97,31,79,207
Teqemt,2nd,2010,Oromia,East Hararge,Melka Belo,26,76,35,137
Yekatit,6th,2010,Oromia,West Wellega,Homa,79,56,37,172
Yekatit,6th,2010,Oromia,Ambo Town,Ambo Town,76,82,36,194
Sene,10th,2011,Oromia,West Shewa,Ambo Hospital,18,20,62,100
Megabit,7th,2011,Oromia,East Wellega,Gobu Seyo,71,4,43,118
Yekatit,6th,2010,Oromia,East Wellega,Jimma Arjo,63,53,40,156
Hamle,11th,2010,Oromia,Bale,Seweyna,49,52,13,114
Ginbot,9th,2009,Oromia,Bale,Raitu,43,86,53,182
Teqemt,2nd,2011,Oromia,East Shewa,Adami Tulu Jido Kombolcha,47,50,51,148
Teqemt,2nd,2011,Oromia,South West Shewa,Ilu,4,21,3,28
Megabit,7th,2009,Oromia,North Shewa,Wuchale,12,40,15,67
Hamle,11th,2010,Oromia,Dukem Town,Dukem Town,97,53,43,193
Nehase,12th,2009,Oromia,Bale,Gura Dhamole,46,50,19,115
Ginbot,9th,2009,Oromia,East Wellega,Limu,34,26,25,85
Nehase,12th,2010,Oromia,East Wellega,Sasiga,98,70,87,255
Tir,5th,2009,Oromia,West Arsi,Kore,61,61,18,140
Meskerem,1st,2011,Oromia,West Shewa,Ejerie,15,20,8,43
Hedar,3rd,2010,Oromia,Arsi,Deksis,24,97,93,214
Hamle,11th,2010,Oromia,Jimma,B/Tolyi,4,18,42,64
Tir,5th,2009,Oromia,East Hararge,Babile,36,24,41,101
Yekatit,6th,2011,Oromia,Jimma,Dedo,28,27,48,103
Megabit,7th,2010,Oromia,Qeleme Wellega,Anfilo,81,27,20,128
Ginbot,9th,2011,Oromia,West Wellega,Nole Kaba,86,42,48,176
Ginbot,9th,2011,Oromia,Guji,Saba Boru,71,56,76,203
Sene,10th,2010,Oromia,Arsi,Jeju,43,18,97,158
Miyazia,8th,2011,Oromia,East Wellega,Nunu Qumba,80,90,30,200
Miyazia,8th,2010,Oromia,Jimma,Limu Hospital,52,29,0,81
Hamle,11th,2010,Oromia,Ilu Aba Bora,Nono Sele,63,59,92,214
Miyazia,8th,2011,Oromia,East Hararge,Chinakesen,98,19,62,179
Tir,5th,2011,Oromia,West Wellega,Mendi Town,46,47,14,107
Miyazia,8th,2011,Oromia,East Shewa,Adea,70,56,16,142
Meskerem,1st,2011,Oromia,West Arsi,Kokosa  Hospital,81,83,15,179
Tir,5th,2010,Oromia,West Wellega,Haru,94,83,81,258
Miyazia,8th,2011,Oromia,Buno Bedele,Diga,99,78,28,205
Hedar,3rd,2011,Oromia,Borena,Meyo,8,42,68,118
Hedar,3rd,2011,Oromia,Qeleme Wellega,Hawa Gelan Hosp,86,52,63,201
Sene,10th,2011,Oromia,Jimma,Guma,12,60,39,111
Tir,5th,2009,Oromia,Horo Gudru Wellega,Shambu Town,30,49,73,152
Miyazia,8th,2011,Oromia,Buno Bedele,Bedele Zuriya,5,29,95,129
Miyazia,8th,2010,Oromia,West Arsi,Hebal Arsi,3,16,19,38
Tir,5th,2010,Oromia,West Wellega,Mendi Town,3,42,61,106
Tir,5th,2010,Oromia,North Shewa,Aleiltu,39,7,6,52
Tir,5th,2010,Oromia,West Guji,Kercha,3,32,41,76
Sene,10th,2010,Oromia,Jimma,Setema,41,77,43,161
Teqemt,2nd,2011,Oromia,West Wellega,Mene Sibu,72,59,26,157
Sene,10th,2010,Oromia,East Shewa,Adami Tulu Jido Kombolcha,16,63,44,123
Miyazia,8th,2009,Oromia,Qeleme Wellega,Jimma Horo,6,7,3,16
Teqemt,2nd,2011,Oromia,Nekemte Town,Nekemte Town,39,35,68,142
Sene,10th,2009,Oromia,Buno Bedele,Chewaqa,51,63,30,144
Meskerem,1st,2011,Oromia,Guji,Aga Wayyu,86,38,36,160
Tahesas,4th,2010,Oromia,West Shewa,Ginde Beret,59,66,80,205
Sene,10th,2009,Oromia,Ilu Aba Bora,Doreni,97,50,13,160
Ginbot,9th,2011,Oromia,East Wellega,Ebantu,27,60,31,118
Tahesas,4th,2010,Oromia,Bale,Delo Mena,88,54,18,160
Ginbot,9th,2009,Oromia,Guji,Adola Hospital,94,23,7,124
Ginbot,9th,2010,Oromia,Borena,Dire,4,56,49,109
Sene,10th,2011,Oromia,Finfine Zuria,Berreh,37,94,23,154
Sene,10th,2010,Oromia,West Hararge,Chiro Zuriya,13,63,60,136
Tir,5th,2011,Oromia,Borena,Teltele,40,51,81,172
Miyazia,8th,2011,Oromia,West Shewa,Jeldu,39,35,36,110
Miyazia,8th,2009,Oromia,East Hararge,Goro Muti,47,39,64,150
Meskerem,1st,2011,Oromia,Finfine Zuria,Sululta Town,40,83,89,212
Megabit,7th,2010,Oromia,Horo Gudru Wellega,Jarte Jardga,70,36,98,204
Sene,10th,2011,Oromia,West Shewa,Gindeberet Hospital,99,9,41,149
Meskerem,1st,2010,Oromia,Arsi,Shirka,1,87,71,159
Miyazia,8th,2009,Oromia,East Wellega,Jimma Arjo,73,26,81,180
Tir,5th,2011,Oromia,West Arsi,Kokosa  Hospital,90,28,50,168
Hedar,3rd,2010,Oromia,West Shewa,Abuna Gindeberet,11,81,35,127
Tahesas,4th,2011,Oromia,South West Shewa,Bantu  Hospital,63,8,24,95
Teqemt,2nd,2010,Oromia,West Wellega,Gimbi,40,36,60,136
Ginbot,9th,2009,Oromia,Jimma Spe Town,Jimma Spe Town,14,11,68,93
Miyazia,8th,2010,Oromia,Jimma,Sigmo,71,14,97,182
Sene,10th,2010,Oromia,West Shewa,Bako Tibe,70,48,31,149
Megabit,7th,2010,Oromia,West Arsi,Kokosa  Hospital,69,84,85,238
Meskerem,1st,2011,Oromia,East Hararge,Deder Town,47,45,0,92
Ginbot,9th,2009,Oromia,West Hararge,Meiso,15,14,29,58
Megabit,7th,2011,Oromia,East Hararge,Kombolicha,58,57,42,157
Yekatit,6th,2009,Oromia,East Shewa,Batu,85,50,6,141
Miyazia,8th,2009,Oromia,West Hararge,Chiro Zuriya,37,9,25,71
Hedar,3rd,2011,Oromia,West Hararge,Burka Dimtu,99,71,38,208
Tir,5th,2010,Oromia,West Hararge,Gemechis,0,42,95,137
Meskerem,1st,2011,Oromia,West Shewa,Adea Berga,45,47,83,175
Meskerem,1st,2011,Oromia,West Wellega,Boji Cheqorsa,12,64,31,107
Hamle,11th,2010,Oromia,West Wellega,Mendi Town,9,88,39,136
Ginbot,9th,2010,Oromia,South West Shewa,Ameya,54,97,63,214
Yekatit,6th,2009,Oromia,East Hararge,Gursum,95,63,10,168
Tahesas,4th,2011,Oromia,West Shewa,Jibat,61,35,36,132
Yekatit,6th,2010,Oromia,West Wellega,Gimbi,29,90,70,189
Megabit,7th,2009,Oromia,West Guji,Biebirsa Kojowa,54,29,70,153
Tahesas,4th,2011,Oromia,Qeleme Wellega,Anfilo,25,67,23,115
Hamle,11th,2009,Oromia,West Shewa,Midakegni,75,39,49,163
Meskerem,1st,2010,Oromia,Bale,Agarfa,79,21,89,189
Tahesas,4th,2010,Oromia,West Shewa,Bako Tibe,64,54,53,171
Hedar,3rd,2010,Oromia,Guji,Negele Town,90,43,38,171
Megabit,7th,2011,Oromia,Guji,Shakiso Town,90,26,27,143
Megabit,7th,2011,Oromia,East Wellega,Ebantu,89,73,82,244
Hamle,11th,2009,Oromia,Bale,Meda Welabu,19,48,63,130
Ginbot,9th,2009,Oromia,West Wellega,Qiltu Kara,96,57,8,161
Tir,5th,2011,Oromia,West Wellega,Boji Dermeji,40,7,63,110
Megabit,7th,2011,Oromia,Ilu Aba Bora,Metu Rural,25,86,33,144
Ginbot,9th,2011,Oromia,West Wellega,Mene Sibu,9,32,10,51
Yekatit,6th,2009,Oromia,Qeleme Wellega,Gidami,98,71,94,263
Miyazia,8th,2010,Oromia,Buno Bedele,Bedele Town,36,1,93,130
Tir,5th,2009,Oromia,North Shewa,Debre Libanos,84,55,36,175
Nehase,12th,2009,Oromia,West Shewa,Nono,77,98,39,214
Sene,10th,2009,Oromia,West Wellega,Qiltu Kara,82,28,92,202
Yekatit,6th,2009,Oromia,East Shewa,Boset,68,50,38,156
Ginbot,9th,2009,Oromia,West Wellega,Genji,91,94,37,222
Ginbot,9th,2010,Oromia,West Shewa,Jibat,76,90,99,265
Megabit,7th,2010,Oromia,Jimma,Mana,72,41,39,152
Teqemt,2nd,2010,Oromia,Arsi,Jeju,25,46,58,129
Sene,10th,2011,Oromia,Horo Gudru Wellega,Shambu Town,17,76,83,176
Megabit,7th,2011,Oromia,West Shewa,Dano,14,65,12,91
Nehase,12th,2010,Oromia,East Wellega,Gobu Seyo,51,85,18,154
Miyazia,8th,2011,Oromia,Borena,Moyale,42,34,4,80
Meskerem,1st,2010,Oromia,Buno Bedele,Diga,45,5,17,67
Ginbot,9th,2010,Oromia,Arsi,Tiyo,22,57,38,117
Miyazia,8th,2009,Oromia,Arsi,Robe,1,77,90,168
Tir,5th,2009,Oromia,West Shewa,Chelia,64,11,25,100
Teqemt,2nd,2011,Oromia,East Shewa,Lomme,51,72,97,220
Ginbot,9th,2011,Oromia,Guji,Saba Boru,93,78,33,204
Tir,5th,2011,Oromia,East Hararge,Meta,58,86,78,222
Megabit,7th,2011,Oromia,Arsi,Zeway Dugda,72,96,57,225
Hedar,3rd,2011,Oromia,Finfine Zuria,Walmera,3,7,61,71
Miyazia,8th,2011,Oromia,Borena,Teltele,61,43,99,203
Megabit,7th,2009,Oromia,West Arsi,Wondo,94,96,50,240
Megabit,7th,2010,Oromia,Bale,Goba,80,79,27,186
Hedar,3rd,2010,Oromia,East Hararge,Garemuleta Hospital,11,26,32,69
Megabit,7th,2009,Oromia,Guji,Wadara,45,48,8,101
Teqemt,2nd,2010,Oromia,East Hararge,Bedeno,66,93,18,177
Hamle,11th,2009,Oromia,West Shewa,Gojo Hospital,61,20,52,133
Sene,10th,2009,Oromia,West Shewa,Jibat,7,27,60,94
Nehase,12th,2009,Oromia,West Shewa,Liban Jawi,78,92,73,243
Yekatit,6th,2010,Oromia,West Guji,Bule Hora Toun,47,5,93,145
Hedar,3rd,2010,Oromia,Guji,Wadara,8,37,10,55
Megabit,7th,2011,Oromia,South West Shewa,Seden Sodo,42,97,75,214
Ginbot,9th,2009,Oromia,West Wellega,Gimbi Public  Hospital,14,11,99,124
Sene,10th,2011,Oromia,Horo Gudru Wellega,Jima Rare,41,36,94,171
Megabit,7th,2009,Oromia,East Hararge,Gole Oda,80,66,34,180
Hedar,3rd,2011,Oromia,Guji,Dima,91,54,36,181
Teqemt,2nd,2011,Oromia,Qeleme Wellega,Dambi Dolo Hospital,68,74,92,234
Megabit,7th,2009,Oromia,East Shewa,Adea,29,21,81,131
Tahesas,4th,2010,Oromia,Guji,Negele Hospital,98,46,80,224
Hedar,3rd,2010,Oromia,Jimma,Omonada,85,72,15,172
Ginbot,9th,2010,Oromia,South West Shewa,Seden Sodo,76,11,56,143
Sene,10th,2010,Oromia,South West Shewa,Ameya,5,6,7,18
Sene,10th,2010,Oromia,West Hararge,Chiro Town,99,91,13,203
Tir,5th,2009,Oromia,Arsi,Digeluna Tijo,78,36,60,174
Hedar,3rd,2010,Oromia,East Hararge,Aweday Town,27,18,5,50
Megabit,7th,2009,Oromia,Bale,Goro,0,47,25,72
Miyazia,8th,2009,Oromia,West Hararge,West Harerge	Gumbi Bordede,78,78,11,167
Hedar,3rd,2010,Oromia,Guji,Wadara,87,97,97,281
Tir,5th,2011,Oromia,Jimma,Omo Nada Hospital,45,78,75,198
Teqemt,2nd,2011,Oromia,Bale,Ginir,59,33,36,128
Miyazia,8th,2009,Oromia,East Hararge,Haromaya Hospital,53,41,3,97
Megabit,7th,2009,Oromia,Horo Gudru Wellega,Hababo Guduru,13,47,72,132
Tir,5th,2011,Oromia,East Shewa,Lomme,37,41,0,78
Sene,10th,2010,Oromia,West Arsi,Kore,23,3,90,116
Meskerem,1st,2011,Oromia,West Shewa,Tikur Enchini,20,23,42,85
Sene,10th,2009,Oromia,Borena,Arero,34,79,91,204
Miyazia,8th,2009,Oromia,West Arsi,Arsi Negele Rural,21,54,75,150
Nehase,12th,2010,Oromia,South West Shewa,Tulu Bolo Hospital,22,51,47,120
Teqemt,2nd,2011,Oromia,Finfine Zuria,Berreh,4,32,16,52
Sene,10th,2009,Oromia,Bale,Goba,6,11,39,56
Nehase,12th,2010,Oromia,Guji,Odo Shakiso,97,75,49,221
Ginbot,9th,2010,Oromia,Arsi,Bekoji Town,14,89,79,182
Ginbot,9th,2010,Oromia,Buno Bedele,Bedele Town,17,48,1,66
Tir,5th,2011,Oromia,Qeleme Wellega,Hawa Gelan Hosp,31,49,83,163
Ginbot,9th,2011,Oromia,West Shewa,Tikur Enchini,13,62,29,104
Hamle,11th,2009,Oromia,Guji,Wadara,18,25,22,65
Hedar,3rd,2010,Oromia,East Hararge,Midega Tole,13,30,54,97
Yekatit,6th,2011,Oromia,Assela Town,Assela Town,63,64,72,199
Megabit,7th,2011,Oromia,Buno Bedele,Meko,81,89,57,227
Tir,5th,2009,Oromia,Qeleme Wellega,Yemalogi Wolel,58,86,77,221
Sene,10th,2009,Oromia,West Wellega,Gimbi Rural,90,92,55,237
Tir,5th,2009,Oromia,East Wellega,Nunu Qumba,89,45,33,167
Tahesas,4th,2011,Oromia,Qeleme Wellega,Gidami Hosp,81,37,88,206
Hedar,3rd,2010,Oromia,West Guji,Kercha Hospital,74,69,28,171
Sene,10th,2009,Oromia,West Wellega,Nejo Hospital,66,67,62,195
Megabit,7th,2010,Oromia,Arsi,Robe,21,65,86,172
Nehase,12th,2009,Oromia,Bale,Gura Dhamole,16,31,17,64
Megabit,7th,2009,Oromia,Borena,Teltele,68,46,61,175
Megabit,7th,2009,Oromia,West Arsi,Gambo Hospital,84,63,69,216
Tir,5th,2010,Oromia,East Wellega,Wama Hagelo,90,56,42,188
Tahesas,4th,2010,Oromia,Arsi,Tiyo,35,52,17,104
Miyazia,8th,2010,Oromia,Ilu Aba Bora,Bilonopa,74,39,43,156
Miyazia,8th,2011,Oromia,Borena,Dhas,97,44,70,211
Tir,5th,2011,Oromia,Borena,Dire,19,46,67,132
Hedar,3rd,2010,Oromia,West Arsi,Shala,90,24,14,128
Sene,10th,2009,Oromia,South West Shewa,Goro,81,64,73,218
Tahesas,4th,2010,Oromia,Ilu Aba Bora,Metu Town,48,56,3,107
Nehase,12th,2010,Oromia,Horo Gudru Wellega,Jarte Jardga,12,83,65,160
Ginbot,9th,2010,Oromia,West Hararge,Gemechis,67,86,43,196
Yekatit,6th,2009,Oromia,Bale,Seweyna,41,7,69,117
Hedar,3rd,2010,Oromia,Borena,Yabelo Hospital,29,72,87,188
Tahesas,4th,2011,Oromia,East Wellega,Nunu Qumba,30,75,49,154
Miyazia,8th,2011,Oromia,West Wellega,Kundala,76,44,80,200
Yekatit,6th,2010,Oromia,West Shewa,Tikur Enchini,95,1,21,117
Nehase,12th,2010,Oromia,Borena,Yabelo,13,14,61,88
Megabit,7th,2009,Oromia,Arsi,Zeway Dugda,24,73,14,111
Tahesas,4th,2011,Oromia,West Wellega,Nejo Rural,60,15,53,128
Megabit,7th,2010,Oromia,East Hararge,Haromaya Hospital,25,96,53,174
Megabit,7th,2010,Oromia,Bale,Goba,98,49,35,182
Teqemt,2nd,2010,Oromia,East Shewa,Gimbichu,64,76,27,167
Ginbot,9th,2009,Oromia,West Guji,Biebirsa Kojowa,8,50,64,122
Ginbot,9th,2010,Oromia,Qeleme Wellega,Gidami,4,70,68,142
Teqemt,2nd,2011,Oromia,Borena,Dubluk,43,78,7,128
Megabit,7th,2009,Oromia,East Hararge,Kumbi,62,11,30,103
Hedar,3rd,2011,Oromia,Finfine Zuria,Walmera,85,84,15,184
Ginbot,9th,2009,Oromia,West Shewa,Gedo Hospital,51,7,98,156
Sene,10th,2011,Oromia,West Shewa,Gojo Hospital,31,52,25,108
Hedar,3rd,2011,Oromia,Arsi,Aseko,59,83,68,210
Ginbot,9th,2011,Oromia,North Shewa,Jido,43,24,52,119
Megabit,7th,2011,Oromia,East Hararge,Deder Town,11,84,99,194
Miyazia,8th,2011,Oromia,South West Shewa,Goro,43,47,12,102
Meskerem,1st,2011,Oromia,North Shewa,Kimbibit,56,66,41,163
Teqemt,2nd,2010,Oromia,Buno Bedele,Meko,43,62,15,120
Nehase,12th,2009,Oromia,Ilu Aba Bora,Becho,96,65,56,217
Megabit,7th,2010,Oromia,West Shewa,Meta Waliqite,15,91,2,108
Sene,10th,2010,Oromia,Woliso Town,Woliso Town,90,82,98,270
Sene,10th,2009,Oromia,Ilu Aba Bora,Doreni,11,40,59,110
Nehase,12th,2010,Oromia,West Hararge,Guba Qoricha,63,14,22,99
Miyazia,8th,2010,Oromia,Finfine Zuria,Mullo,10,54,80,144
Hamle,11th,2010,Oromia,West Wellega,Mendi Hospital,46,21,36,103
Yekatit,6th,2009,Oromia,West Guji,Dugda Dawa,43,73,14,130
Ginbot,9th,2010,Oromia,Arsi,Seru,23,73,78,174
Tahesas,4th,2011,Oromia,Arsi,Sire,54,42,83,179
Teqemt,2nd,2011,Oromia,Horo Gudru Wellega,Amuru,50,8,18,76
Teqemt,2nd,2011,Oromia,West Shewa,Guder Hosp,37,35,15,87
Tahesas,4th,2011,Oromia,West Shewa,Ambo,58,27,67,152
Tir,5th,2010,Oromia,Bale,Dawe Qachen,17,56,34,107
Hedar,3rd,2011,Oromia,Guji,Dima,32,24,0,56
Ginbot,9th,2009,Oromia,Bishoftu Town,Bishoftu Town,27,78,44,149
Sene,10th,2009,Oromia,Buno Bedele,Bedele Town,50,64,8,122
Nehase,12th,2010,Oromia,West Shewa,Bako Hospital,5,42,6,53
Nehase,12th,2010,Oromia,North Shewa,Were Jarso,36,17,5,58
Tahesas,4th,2010,Oromia,Horo Gudru Wellega,Jarte Jardga,41,41,56,138
Meskerem,1st,2010,Oromia,Arsi,Sude,14,70,82,166
Ginbot,9th,2010,Oromia,Jimma,Limu Seka,28,48,67,143
Tir,5th,2011,Oromia,Arsi,Limuna Bilbilo,56,58,8,122
Hedar,3rd,2011,Oromia,Guji,Aga Wayyu,71,13,49,133
Ginbot,9th,2011,Oromia,West Wellega,Mendi Hospital,55,22,42,119
Hedar,3rd,2011,Oromia,East Hararge,Fedis,97,89,94,280
Ginbot,9th,2010,Oromia,West Shewa,Tibe Kutaye,19,53,96,168
Ginbot,9th,2010,Oromia,East Hararge,Goro Gutu,45,60,11,116
Ginbot,9th,2010,Oromia,Jimma,Agaro,59,27,55,141
Megabit,7th,2009,Oromia,West Wellega,Nejo Rural,99,51,82,232
Miyazia,8th,2011,Oromia,West Arsi,Gambo Hospital,54,81,58,193
Nehase,12th,2010,Oromia,East Hararge,Meyu Muleke,1,68,62,131
Hedar,3rd,2010,Oromia,Bale,Gasera,16,40,85,141
Ginbot,9th,2011,Oromia,Arsi,Amigna,54,56,33,143
Sene,10th,2009,Oromia,North Shewa,Kuyu Hospital,63,12,73,148
Tahesas,4th,2011,Oromia,South West Shewa,Ameya Hospital,43,77,83,203
Megabit,7th,2011,Oromia,East Shewa,Adea,78,18,40,136
Nehase,12th,2010,Oromia,North Shewa,Fiche Hospital,78,71,11,160
Hamle,11th,2009,Oromia,East Shewa,Liben,27,77,13,117
Yekatit,6th,2010,Oromia,Gelan Town,Gelan Town,7,99,80,186
Megabit,7th,2011,Oromia,Bale,Gololcha,51,45,45,141
Tir,5th,2010,Oromia,Bale,Berbere,76,24,2,102
Hedar,3rd,2010,Oromia,West Shewa,Adea Berga,65,72,42,179
Tir,5th,2011,Oromia,Guji,Adola Town,26,92,28,146
Megabit,7th,2011,Oromia,Qeleme Wellega,Gidami,80,36,6,122
Yekatit,6th,2010,Oromia,East Wellega,Haro Limu,80,29,45,154
Teqemt,2nd,2010,Oromia,North Shewa,Wuchale,14,10,23,47
Tir,5th,2009,Oromia,West Shewa,Tikur Enchini,29,16,0,45
Teqemt,2nd,2010,Oromia,West Arsi,Dodola Rural,9,20,77,106
Tir,5th,2011,Oromia,West Hararge,Anchar,83,6,27,116
Nehase,12th,2010,Oromia,Bale,Ginir Town,36,19,86,141
Meskerem,1st,2010,Oromia,Guji,Adola Reda,54,84,98,236
Miyazia,8th,2011,Oromia,North Shewa,Wuchale,44,64,27,135
Miyazia,8th,2010,Oromia,Qeleme Wellega,Anfilo,97,39,82,218
Tir,5th,2009,Oromia,West Hararge,West Harerge	Gumbi Bordede,38,57,5,100
Hedar,3rd,2010,Oromia,East Shewa,Fentale,82,13,12,107
Tir,5th,2010,Oromia,Qeleme Wellega,Laloqile,47,77,66,190
Tir,5th,2011,Oromia,Jimma,Sigmo,83,36,51,170
Sene,10th,2011,Oromia,West Shewa,Ginde Beret,49,28,47,124
Hedar,3rd,2010,Oromia,Guji,Uraga,1,95,25,121
Nehase,12th,2010,Oromia,East Hararge,Chinakesen,54,17,39,110
Hedar,3rd,2011,Oromia,West Guji,Suro Barguda,3,70,55,128
Tahesas,4th,2011,Oromia,Borena,Guchi,21,99,80,200
Yekatit,6th,2010,Oromia,East Hararge,Babile,88,2,62,152
Tir,5th,2009,Oromia,Borena,Gomole,34,95,61,190
Hamle,11th,2010,Oromia,Jimma,Setema Hospital,84,80,30,194
Hedar,3rd,2011,Oromia,Bale,Ginir Town,48,17,1,66
Tir,5th,2011,Oromia,West Arsi,Gambo Hospital,49,61,30,140
Teqemt,2nd,2010,Oromia,Ilu Aba Bora,Becho,55,80,27,162
Ginbot,9th,2010,Oromia,Borena,Wachile,17,75,6,98
Nehase,12th,2009,Oromia,West Guji,Bule Hora,79,39,48,166
Miyazia,8th,2011,Oromia,Finfine Zuria,Akaki,84,61,41,186
Tir,5th,2009,Oromia,Guji,Aga Wayyu,83,52,3,138
Sene,10th,2011,Oromia,West Hararge,Habro,18,20,28,66
Hamle,11th,2009,Oromia,Arsi,Bekoji Town,6,59,48,113
Yekatit,6th,2009,Oromia,East Shewa,Olanciti Hospital,65,51,86,202
Miyazia,8th,2011,Oromia,West Shewa,Ejersa Lafo,2,6,12,20
Ginbot,9th,2009,Oromia,Arsi,Seru,63,7,85,155
Ginbot,9th,2010,Oromia,Finfine Zuria,Mullo,17,31,83,131
Ginbot,9th,2011,Oromia,Woliso Town,Woliso Town,44,96,22,162
Nehase,12th,2009,Oromia,West Hararge,Oda Bultum,39,52,82,173
Hedar,3rd,2010,Oromia,North Shewa,Debre Libanos,59,79,44,182
Nehase,12th,2009,Oromia,Guji,Adola Hospital,83,14,90,187
Sene,10th,2009,Oromia,West Guji,Biebirsa Kojowa,86,60,37,183
Sene,10th,2009,Oromia,Jimma,Gera,9,76,2,87
Hedar,3rd,2011,Oromia,Ilu Aba Bora,Bure,91,54,31,176
Megabit,7th,2009,Oromia,Ilu Aba Bora,Metu Town,21,42,26,89
Ginbot,9th,2009,Oromia,West Guji,Bule Hora Toun,46,85,56,187
Sene,10th,2009,Oromia,West Shewa,Ambo,13,74,74,161
Nehase,12th,2009,Oromia,East Hararge,Aweday Town,32,96,38,166
Tir,5th,2009,Oromia,South West Shewa,Tulu Bolo Hospital,68,93,67,228
Tahesas,4th,2010,Oromia,West Hararge,Daro Lebu,1,79,68,148
Megabit,7th,2009,Oromia,East Wellega,Limu,58,8,67,133
Hamle,11th,2010,Oromia,West Hararge,Bedesa Town,75,47,10,132
Megabit,7th,2009,Oromia,Bale,Seweyna,12,11,82,105
Ginbot,9th,2009,Oromia,Horo Gudru Wellega,Abay Chomen,34,41,66,141
Ginbot,9th,2009,Oromia,West Shewa,Meta Waliqite,64,27,52,143
Miyazia,8th,2010,Oromia,Jimma,Omonada,64,46,25,135
Megabit,7th,2009,Oromia,Guji,Liben,51,8,81,140
Nehase,12th,2010,Oromia,West Arsi,Gambo Hospital,88,10,3,101
Teqemt,2nd,2010,Oromia,East Shewa,Adea,61,37,16,114
Tir,5th,2011,Oromia,West Hararge,Tulo,99,79,84,262
Sene,10th,2009,Oromia,Bale,Gololcha,8,38,76,122
Ginbot,9th,2009,Oromia,Arsi,Munesa,31,14,21,66
Yekatit,6th,2010,Oromia,Bale,Ginir Town,9,56,32,97
Sene,10th,2010,Oromia,East Hararge,Goro Muti,50,15,83,148
Hamle,11th,2009,Oromia,East Hararge,Babile,59,35,34,128
Sene,10th,2010,Oromia,Arsi,Gololcha,95,28,69,192
Yekatit,6th,2009,Oromia,North Shewa,Debre Libanos,86,77,96,259
Tir,5th,2010,Oromia,Borena,Yabelo Rural,64,90,90,244
Meskerem,1st,2010,Oromia,Borena,Teltele,0,32,78,110
Nehase,12th,2010,Oromia,West Arsi,Kokosa  Hospital,25,28,2,55
Miyazia,8th,2011,Oromia,West Guji,Kercha,94,55,9,158
Tahesas,4th,2010,Oromia,West Shewa,Adea Berga,69,74,88,231
Hedar,3rd,2011,Oromia,North Shewa,Dera Hospital,72,67,0,139
Yekatit,6th,2010,Oromia,Arsi,Seru,47,66,36,149
Sene,10th,2010,Oromia,Ilu Aba Bora,Didu,63,77,64,204
Nehase,12th,2009,Oromia,Guji,Hambela Wamena,96,17,67,180
Nehase,12th,2009,Oromia,East Hararge,Meyu Muleke,60,23,36,119
Meskerem,1st,2011,Oromia,West Shewa,Bako Hospital,47,18,57,122
Hedar,3rd,2011,Oromia,Horo Gudru Wellega,Shambu Hospital,83,93,23,199
Hamle,11th,2010,Oromia,Guji,Adola Town,98,22,62,182
Hedar,3rd,2011,Oromia,South West Shewa,Ameya Hospital,82,15,22,119
Miyazia,8th,2009,Oromia,Guji,Gumi Eldallo,49,0,10,59
Ginbot,9th,2011,Oromia,Holeta Town,Holeta Town,0,41,8,49
Nehase,12th,2010,Oromia,West Arsi,Wondo,51,64,58,173
Sene,10th,2010,Oromia,West Arsi,Kokosa  Hospital,36,73,96,205
Sene,10th,2009,Oromia,Qeleme Wellega,Dale Sedi,86,52,80,218
Tir,5th,2011,Oromia,Borena,Yabelo Rural,67,15,76,158
Yekatit,6th,2009,Oromia,West Shewa,Dano,91,89,27,207
Yekatit,6th,2010,Oromia,Qeleme Wellega,Dale Sedi,53,68,90,211
Hedar,3rd,2011,Oromia,Bale,Legehida,59,3,65,127
Yekatit,6th,2009,Oromia,Bishoftu Town,Bishoftu Town,7,18,17,42
Ginbot,9th,2011,Oromia,Bale,Arena Buluq,77,28,33,138
Tir,5th,2011,Oromia,Borena,Yabelo Hospital,79,23,48,150
Tahesas,4th,2010,Oromia,Guji,Adola Reda,36,52,10,98
Hamle,11th,2009,Oromia,East Wellega,Limu,18,77,46,141
Megabit,7th,2010,Oromia,East Shewa,Adami Tulu Jido Kombolcha,24,33,24,81
Tir,5th,2011,Oromia,Guji,Wadara,29,80,50,159
Megabit,7th,2010,Oromia,East Wellega,Sibu Sire,47,55,68,170
Sene,10th,2011,Oromia,West Hararge,Hawi Gudina,76,12,99,187
Teqemt,2nd,2010,Oromia,West Arsi,Gedeb Asasa,93,54,44,191
Ginbot,9th,2011,Oromia,Dukem Town,Dukem Town,19,39,34,92
Sene,10th,2010,Oromia,Borena,Teltele,26,27,90,143
Tir,5th,2009,Oromia,Finfine Zuria,Walmera,69,9,99,177
Teqemt,2nd,2010,Oromia,East Shewa,Olanciti Hospital,69,25,72,166
Nehase,12th,2010,Oromia,East Shewa,Adama,92,27,21,140
Ginbot,9th,2010,Oromia,West Shewa,Tibe Kutaye,98,83,3,184
Nehase,12th,2009,Oromia,West Shewa,Ambo Town,1,77,22,100
Yekatit,6th,2011,Oromia,West Wellega,Mendi Town,49,83,18,150
Sene,10th,2009,Oromia,Lege Dadi Lege Tafo Town,Lege Dadi Lege Tafo Town,90,55,86,231
Tahesas,4th,2011,Oromia,East Wellega,Kiremu,9,5,97,111
Nehase,12th,2010,Oromia,Bale,Goba,63,53,49,165
Teqemt,2nd,2011,Oromia,Jimma,Gomma,70,45,89,204
Tir,5th,2010,Oromia,West Arsi,Kofele,1,75,44,120
Tir,5th,2011,Oromia,Sululta Town,Sululta Town,17,14,34,65
Yekatit,6th,2011,Oromia,North Shewa,Fiche Hospital,82,57,5,144
Hedar,3rd,2011,Oromia,Guji,Adola Reda,71,36,85,192
Megabit,7th,2010,Oromia,North Shewa,Fiche Hospital,59,25,92,176
Megabit,7th,2009,Oromia,Horo Gudru Wellega,Shambu Town,79,99,43,221
Nehase,12th,2010,Oromia,West Shewa,Tibe Kutaye,26,5,6,37
Tir,5th,2011,Oromia,West Shewa,Ejersa Lafo,73,92,7,172
Ginbot,9th,2011,Oromia,Arsi,Munesa,63,40,45,148
Sene,10th,2009,Oromia,West Guji,Mkelka Soda,24,2,38,64
Megabit,7th,2009,Oromia,East Wellega,Limu,53,80,80,213
Sene,10th,2009,Oromia,Bale,Sinana,56,27,52,135
Miyazia,8th,2010,Oromia,South West Shewa,Ilu,50,48,34,132
Sene,10th,2011,Oromia,West Arsi,Kore,66,36,97,199
Sene,10th,2010,Oromia,East Hararge,Girawa,35,48,66,149
Nehase,12th,2010,Oromia,East Hararge,Deder Hospital,16,53,68,137
Tir,5th,2011,Oromia,Bale,Dinsho,15,35,65,115
Ginbot,9th,2010,Oromia,Jimma,B/Tolyi,48,92,92,232
Ginbot,9th,2011,Oromia,South West Shewa,Ameya,63,5,52,120
Ginbot,9th,2011,Oromia,West Hararge,Bedesa Town,95,50,20,165
Teqemt,2nd,2010,Oromia,Qeleme Wellega,Yemalogi Wolel,77,42,20,139
Hedar,3rd,2010,Oromia,North Shewa,Dera Hospital,78,42,30,150
Tahesas,4th,2010,Oromia,Buno Bedele,Bedele Zuriya,96,49,10,155
Hamle,11th,2009,Oromia,West Shewa,Dano,96,90,71,257
Sene,10th,2010,Oromia,West Wellega,Nejo Hospital,15,35,87,137
Tir,5th,2009,Oromia,Guji,Bore,39,67,11,117
Meskerem,1st,2010,Oromia,West Wellega,Mendi Hospital,14,97,77,188
Hamle,11th,2010,Oromia,Bale,Seweyna,50,13,8,71
Ginbot,9th,2010,Oromia,Ambo Town,Ambo Town,57,97,69,223
Hedar,3rd,2011,Oromia,Bale,Goro,32,67,58,157
Nehase,12th,2009,Oromia,Guji,Wadara,26,10,93,129
Tir,5th,2011,Oromia,North Shewa,Dera Hospital,19,30,70,119
Miyazia,8th,2010,Oromia,Guji,Girja,4,3,92,99
Ginbot,9th,2011,Oromia,Guji,Negele Town,13,27,59,99
Nehase,12th,2009,Oromia,Bale,Goba Town,53,50,7,110
Hedar,3rd,2010,Oromia,Gelan Town,Gelan Town,37,12,45,94
Hedar,3rd,2011,Oromia,West Wellega,Kundala,67,65,74,206
Tir,5th,2009,Oromia,West Wellega,Genji,7,26,96,129
Nehase,12th,2010,Oromia,Bale,Agarfa,83,27,42,152
Yekatit,6th,2010,Oromia,Horo Gudru Wellega,Gudru,4,75,81,160
Teqemt,2nd,2010,Oromia,Bale,Gura Dhamole,90,19,47,156
Meskerem,1st,2010,Oromia,West Hararge,Oda Bultum,84,62,27,173
Sene,10th,2009,Oromia,Bale,Arena Buluq,63,84,29,176
Miyazia,8th,2010,Oromia,Borena,Meyo,15,29,8,52
Megabit,7th,2011,Oromia,Buno Bedele,Bedele Town,33,95,43,171
Megabit,7th,2011,Oromia,Arsi,Bekoji Town,84,75,97,256
Hedar,3rd,2011,Oromia,Qeleme Wellega,Laloqile,75,45,17,137
Megabit,7th,2010,Oromia,West Wellega,Qiltu Kara,2,32,94,128
Nehase,12th,2010,Oromia,Bale,Raitu,64,96,23,183
Hamle,11th,2009,Oromia,West Guji,Bule Hora,35,40,17,92
Ginbot,9th,2011,Oromia,West Shewa,Nono,58,78,13,149
Tir,5th,2011,Oromia,Finfine Zuria,Mullo,28,45,97,170
Yekatit,6th,2011,Oromia,Borena,Moyale Hospital,30,45,26,101
Nehase,12th,2010,Oromia,East Wellega,Diga,51,63,59,173
Tir,5th,2011,Oromia,Sululta Town,Sululta Town,15,47,28,90
Nehase,12th,2009,Oromia,East Wellega,Ebantu,57,9,12,78
Yekatit,6th,2010,Oromia,Borena,Teltele,15,58,45,118
Miyazia,8th,2011,Oromia,East Shewa,Bora,93,92,30,215
Megabit,7th,2009,Oromia,East Hararge,Haromaya Town,58,54,40,152
Megabit,7th,2010,Oromia,Qeleme Wellega,Yemalogi Wolel,79,5,36,120
Tir,5th,2011,Oromia,East Hararge,Fedis,92,43,45,180
Meskerem,1st,2011,Oromia,Arsi,Tiyo,7,55,25,87
Tir,5th,2010,Oromia,Gelan Town,Gelan Town,70,66,61,197
Yekatit,6th,2009,Oromia,West Guji,Bule Hora Toun,67,72,45,184
Megabit,7th,2011,Oromia,Lege Dadi Lege Tafo Town,Lege Dadi Lege Tafo Town,33,25,16,74
Sene,10th,2009,Oromia,Buno Bedele,Bedele Town,96,77,51,224
Ginbot,9th,2010,Oromia,West Wellega,Mene Sibu,63,45,13,121
Megabit,7th,2011,Oromia,West Arsi,Kokosa  Hospital,95,87,56,238
Sene,10th,2009,Oromia,Jimma,Nono Benja,90,81,3,174
Yekatit,6th,2011,Oromia,East Shewa,Boset,88,16,10,114
Hamle,11th,2010,Oromia,Finfine Zuria,Berreh,42,61,46,149
Ginbot,9th,2011,Oromia,East Hararge,Midega Tole,21,85,88,194
Ginbot,9th,2011,Oromia,Bale,Legehida,17,6,32,55
Hedar,3rd,2011,Oromia,Ilu Aba Bora,Doreni,58,11,71,140
Megabit,7th,2009,Oromia,East Wellega,Gida Ayana,60,43,30,133
Megabit,7th,2011,Oromia,Buno Bedele,Bedele Town,3,83,46,132
Ginbot,9th,2010,Oromia,Jimma,Omonada,11,58,9,78
Megabit,7th,2011,Oromia,South West Shewa,Kersana Malima,18,21,68,107
Meskerem,1st,2011,Oromia,East Wellega,Leqa Dulecha,66,91,83,240
Tir,5th,2010,Oromia,West Wellega,Gimbi,60,6,12,78
Ginbot,9th,2009,Oromia,East Wellega,Gida Ayana,45,45,54,144
Sene,10th,2010,Oromia,East Hararge,Aweday Town,37,99,68,204
Miyazia,8th,2009,Oromia,Arsi,Bekoji Town,29,17,16,62
Tir,5th,2010,Oromia,Gelan Town,Gelan Town,42,57,2,101
Tahesas,4th,2010,Oromia,West Wellega,Mendi Town,56,91,42,189
Nehase,12th,2010,Oromia,West Wellega,Lata Sibu,53,94,69,216
Hamle,11th,2010,Oromia,Arsi,Tiyo,56,95,63,214
Meskerem,1st,2010,Oromia,Guji,Negele Town,81,51,78,210
Ginbot,9th,2010,Oromia,East Shewa,Gimbichu,45,58,93,196
Ginbot,9th,2011,Oromia,West Hararge,Mesela,9,76,8,93
Megabit,7th,2009,Oromia,South West Shewa,St.Luke Hospital,35,98,18,151
Miyazia,8th,2010,Oromia,East Shewa,Adami Tulu Jido Kombolcha,10,33,35,78
Hedar,3rd,2011,Oromia,West Guji,Suro Barguda,26,61,26,113
Meskerem,1st,2010,Oromia,Bale,Legehida,39,71,19,129
Ginbot,9th,2010,Oromia,West Wellega,Seyo Nole,95,71,95,261
Hedar,3rd,2011,Oromia,North Shewa,Girar Jarso,49,22,53,124
Hamle,11th,2010,Oromia,East Wellega,Sasiga,38,38,88,164
Sene,10th,2011,Oromia,North Shewa,Muke Turi Hospital,57,80,41,178
Nehase,12th,2010,Oromia,West Shewa,Liban Jawi,35,43,96,174
Yekatit,6th,2009,Oromia,Nekemte Town,Nekemte Town,69,12,86,167
Nehase,12th,2010,Oromia,South West Shewa,Dawo,90,15,92,197
Ginbot,9th,2010,Oromia,Finfine Zuria,Akaki,31,59,30,120
Tahesas,4th,2011,Oromia,East Hararge,Haromaya Rural,63,34,57,154
Ginbot,9th,2010,Oromia,West Hararge,Doba,10,50,77,137
Teqemt,2nd,2011,Oromia,Finfine Zuria,Walmera,73,67,78,218
Yekatit,6th,2011,Oromia,West Hararge,Guba Qoricha,37,49,28,114
Ginbot,9th,2010,Oromia,West Arsi,Nensebo,10,57,64,131
Yekatit,6th,2009,Oromia,Bale,Goro,23,95,56,174
Nehase,12th,2009,Oromia,Borena,Dubluk,76,79,15,170
Sene,10th,2011,Oromia,Buno Bedele,Dhidesa Hospital,12,35,71,118
Ginbot,9th,2010,Oromia,East Hararge,Meta,91,42,67,200
Sene,10th,2011,Oromia,Finfine Zuria,Walmera,1,82,47,130
Miyazia,8th,2011,Oromia,West Wellega,Jarso,23,34,25,82
Teqemt,2nd,2011,Oromia,Borena,Yabelo,15,34,68,117
Hedar,3rd,2010,Oromia,Borena,Dhas,24,34,3,61
Tir,5th,2011,Oromia,Arsi,Robe,74,38,18,130
Miyazia,8th,2009,Oromia,East Wellega,Limu,51,2,31,84
Ginbot,9th,2011,Oromia,East Shewa,Dugda,54,48,51,153
Yekatit,6th,2010,Oromia,West Hararge,Burka Dimtu,85,71,82,238
Nehase,12th,2009,Oromia,Qeleme Wellega,Anfilo,9,74,68,151
Yekatit,6th,2010,Oromia,East Hararge,Goro Gutu,82,67,0,149
Ginbot,9th,2010,Oromia,East Hararge,Deder Hospital,54,9,18,81
Tir,5th,2010,Oromia,Qeleme Wellega,Seyo,12,6,81,99
Megabit,7th,2009,Oromia,Lege Dadi Lege Tafo Town,Lege Dadi Lege Tafo Town,36,73,29,138
Tahesas,4th,2011,Oromia,North Shewa,Fiche Hospital,27,71,53,151
Tir,5th,2011,Oromia,Ilu Aba Bora,Nono Sele,64,15,84,163
Sene,10th,2010,Oromia,West Hararge,Oda Bultum,51,40,3,94
Yekatit,6th,2010,Oromia,Ilu Aba Bora,Doreni,10,92,60,162
Sene,10th,2009,Oromia,Horo Gudru Wellega,Jarte Jardga,2,79,46,127
Miyazia,8th,2011,Oromia,Horo Gudru Wellega,Shambu Town,90,16,85,191
Tahesas,4th,2011,Oromia,East Shewa,Adami Tulu Jido Kombolcha,87,4,17,108
Sene,10th,2010,Oromia,East Wellega,Leqa Dulecha,56,44,10,110
Megabit,7th,2009,Oromia,Arsi,Bale Gesgara,31,26,52,109
Tahesas,4th,2011,Oromia,Borena,Guchi,62,53,26,141
Sene,10th,2011,Oromia,Lege Dadi Lege Tafo Town,Lege Dadi Lege Tafo Town,77,62,35,174
Megabit,7th,2010,Oromia,Bale,Gasera,65,27,98,190
Megabit,7th,2010,Oromia,Ilu Aba Bora,Nono Sele,50,0,36,86
Tahesas,4th,2011,Oromia,Assela Town,Assela Town,77,59,80,216
Teqemt,2nd,2011,Oromia,West Hararge,Bedesa Town,95,18,14,127
Megabit,7th,2010,Oromia,West Shewa,Nono,83,82,39,204
Megabit,7th,2010,Oromia,Guji,Wadara,5,94,97,196
Tir,5th,2009,Oromia,West Hararge,Daro Lebu,75,15,22,112
Meskerem,1st,2010,Oromia,North Shewa,Kuyu,37,80,73,190
Miyazia,8th,2011,Oromia,West Arsi,Kokosa,3,79,47,129
Tir,5th,2010,Oromia,Borena,Teltele,12,94,51,157
Yekatit,6th,2010,Oromia,West Shewa,Liban Jawi,9,79,7,95
Tahesas,4th,2010,Oromia,West Hararge,Gelemso Hospital,61,72,80,213
Tir,5th,2009,Oromia,West Wellega,Nejo Rural,23,98,88,209
Tir,5th,2011,Oromia,West Shewa,Inchini Hospital,75,41,93,209
Ginbot,9th,2010,Oromia,Ilu Aba Bora,Ale,15,54,79,148
Tahesas,4th,2011,Oromia,Arsi,Jeju,25,12,81,118
Nehase,12th,2009,Oromia,North Shewa,Kimbibit,41,27,8,76
Ginbot,9th,2009,Oromia,North Shewa,Degem,86,53,68,207
Tahesas,4th,2011,Oromia,Horo Gudru Wellega,Jarte Jardga,47,74,86,207
Hamle,11th,2010,Oromia,West Shewa,Bako Tibe,95,73,13,181
Megabit,7th,2010,Oromia,East Wellega,Wama Hagelo,99,73,18,190
Megabit,7th,2010,Oromia,South West Shewa,Tole,95,64,95,254
Sene,10th,2010,Oromia,West Shewa,Tibe Kutaye,4,57,64,125
Miyazia,8th,2011,Oromia,East Hararge,Haromaya Hospital,17,60,8,85
Tahesas,4th,2010,Oromia,West Hararge,Chiro Hospital,78,25,61,164
Nehase,12th,2009,Oromia,Bale,Arena Buluq,25,27,9,61
Miyazia,8th,2011,Oromia,West Arsi,Dodola Rural,12,44,56,112
Miyazia,8th,2011,Oromia,Jimma,Agaro,82,66,38,186
Megabit,7th,2010,Oromia,Arsi,Ludehetosa,82,36,48,166
Megabit,7th,2009,Oromia,West Shewa,Tikur Enchini,37,23,51,111
Hedar,3rd,2011,Oromia,Buno Bedele,Bedele Town,4,74,13,91
Teqemt,2nd,2011,Oromia,Arsi,Jeju,59,17,95,171
Ginbot,9th,2011,Oromia,Arsi,Gololcha,54,74,87,215
Tir,5th,2011,Oromia,North Shewa,Were Jarso,62,69,32,163
Yekatit,6th,2010,Oromia,East Hararge,Kombolicha,10,10,37,57
Hedar,3rd,2011,Oromia,West Guji,Bule Hora Toun,68,12,96,176
Hedar,3rd,2010,Oromia,Buno Bedele,Chora,58,3,86,147
Miyazia,8th,2010,Oromia,Jimma,Sekoru,43,19,38,100
Hamle,11th,2010,Oromia,Guji,Shakiso Town,72,42,70,184
Megabit,7th,2009,Oromia,West Wellega,Lalo Asabi,87,18,85,190
Sene,10th,2011,Oromia,West Shewa,Ejerie,74,1,79,154
Tahesas,4th,2010,Oromia,West Guji,Bule Hora Toun,54,42,18,114
Sene,10th,2010,Oromia,Guji,Bore,23,33,68,124
Tir,5th,2009,Oromia,North Shewa,Yaya Gulele,3,89,58,150
Hedar,3rd,2010,Oromia,South West Shewa,Tulu Bolo Hospital,72,2,36,110
Hedar,3rd,2010,Oromia,South West Shewa,St.Luke Hospital,39,53,57,149
Hamle,11th,2010,Oromia,East Wellega,Sibu Sire,46,8,56,110
Tir,5th,2010,Oromia,Ilu Aba Bora,Yayu,18,61,76,155
Megabit,7th,2010,Oromia,Jimma,Tiro Afeta,14,31,40,85
Megabit,7th,2010,Oromia,West Wellega,Mene Sibu,3,47,66,116
Ginbot,9th,2010,Oromia,Borena,Wachile,99,11,97,207
Nehase,12th,2009,Oromia,West Shewa,Chelia,91,28,79,198
Miyazia,8th,2009,Oromia,Bale,Goba Town,27,74,14,115
Ginbot,9th,2010,Oromia,West Hararge,Doba,42,21,18,81
Megabit,7th,2009,Oromia,Jimma,Limu Seka,67,57,20,144
Hamle,11th,2009,Oromia,East Wellega,Guto Gida,12,90,10,112
Tir,5th,2011,Oromia,Assela Town,Assela Town,44,75,97,216
Tir,5th,2010,Oromia,Guji,Goro Dola,80,87,24,191
Hedar,3rd,2010,Oromia,North Shewa,Kimbibit,12,96,68,176
Tir,5th,2010,Oromia,West Wellega,Begi,65,3,24,92
Hamle,11th,2009,Oromia,West Shewa,Chelia,40,93,93,226
Nehase,12th,2010,Oromia,West Shewa,Gedo Hospital,84,24,97,205
Ginbot,9th,2009,Oromia,South West Shewa,Kersana Malima,87,88,62,237
Hedar,3rd,2010,Oromia,Arsi,Shirka,0,70,55,125
Megabit,7th,2009,Oromia,Borena,Gomole,28,87,4,119
Tir,5th,2011,Oromia,Guji,Goro Dola,66,65,61,192
Nehase,12th,2009,Oromia,Finfine Zuria,Walmera,1,67,24,92
Meskerem,1st,2010,Oromia,Qeleme Wellega,Hawa Gelan,56,54,32,142
Megabit,7th,2010,Oromia,Arsi,Bale Gesgara,78,76,57,211
Hedar,3rd,2011,Oromia,Qeleme Wellega,Gidami,59,96,5,160
Tir,5th,2011,Oromia,Horo Gudru Wellega,Jima Geneti,1,6,71,78
Tir,5th,2011,Oromia,Burayu Town,Burayu Town,63,25,67,155
Tir,5th,2011,Oromia,Qeleme Wellega,Gawo Qebe,24,99,63,186
Tir,5th,2011,Oromia,Bale,Meda Welabu,20,46,71,137
Ginbot,9th,2011,Oromia,Bale,Goro,87,58,89,234
Meskerem,1st,2011,Oromia,Guji,Bore,16,89,59,164
Megabit,7th,2009,Oromia,West Arsi,Nensebo,75,77,10,162
Ginbot,9th,2009,Oromia,Arsi,Chole,32,63,37,132
Ginbot,9th,2009,Oromia,Horo Gudru Wellega,Shambu Town,3,88,48,139
Nehase,12th,2009,Oromia,Guji,Girja,43,53,69,165
Meskerem,1st,2010,Oromia,West Hararge,Guba Qoricha,0,23,10,33
Yekatit,6th,2010,Oromia,Jimma,Tiro Afeta,24,16,75,115
Yekatit,6th,2009,Oromia,Qeleme Wellega,Hawa Gelan,88,68,20,176
Tir,5th,2011,Oromia,Arsi,Aseko,25,72,33,130
Nehase,12th,2010,Oromia,Jimma,Mana,83,4,97,184
Miyazia,8th,2010,Oromia,Sebeta Town,Sebeta Town,26,80,8,114
Megabit,7th,2009,Oromia,Bale,Dinsho,90,10,76,176
Nehase,12th,2009,Oromia,East Wellega,Gobu Seyo,70,22,51,143
Megabit,7th,2010,Oromia,East Hararge,Deder Hospital,5,23,63,91
Tir,5th,2010,Oromia,Borena,Yabelo Hospital,95,59,19,173
Hamle,11th,2009,Oromia,West Shewa,Nono,1,52,73,126
Megabit,7th,2010,Oromia,East Shewa,Lomme,36,30,93,159
Megabit,7th,2011,Oromia,West Wellega,Nejo Hospital,76,94,43,213
Tir,5th,2010,Oromia,North Shewa,Jido,18,99,94,211
Miyazia,8th,2010,Oromia,South West Shewa,St.Luke Hospital,81,98,96,275
Megabit,7th,2011,Oromia,Borena,Gomole,16,45,15,76
Hedar,3rd,2010,Oromia,West Arsi,Kofele,30,65,34,129
Megabit,7th,2009,Oromia,Horo Gudru Wellega,Horo,51,30,63,144
Sene,10th,2009,Oromia,Guji,Odo Shakiso,51,91,45,187
Tahesas,4th,2011,Oromia,Horo Gudru Wellega,Jima Geneti,91,6,93,190
Sene,10th,2010,Oromia,Jimma,Shabe,25,42,71,138
Hamle,11th,2010,Oromia,Jimma,Kersa,66,14,18,98
Megabit,7th,2009,Oromia,West Shewa,Tibe Kutaye,7,22,77,106
Tir,5th,2009,Oromia,South West Shewa,Seden Sodo,97,66,61,224
Hamle,11th,2010,Oromia,West Arsi,Loke Hada Hospital,81,81,69,231
Tir,5th,2009,Oromia,West Hararge,Habro,0,89,37,126
Tahesas,4th,2010,Oromia,Qeleme Wellega,Anfilo,83,29,37,149
Hamle,11th,2009,Oromia,West Hararge,Gemechis,15,95,20,130
Yekatit,6th,2011,Oromia,Buno Bedele,Gechi,3,91,72,166
Nehase,12th,2009,Oromia,Jimma,Nono Benja,87,68,9,164
Sene,10th,2009,Oromia,West Wellega,Gimbi Rural,49,24,73,146
Sene,10th,2011,Oromia,Arsi,Sire,16,78,77,171
Ginbot,9th,2011,Oromia,Ilu Aba Bora,Yayu,59,86,64,209
Tahesas,4th,2011,Oromia,Borena,Arero,70,85,34,189
Hedar,3rd,2010,Oromia,Arsi,Munesa,49,86,77,212
Sene,10th,2009,Oromia,Jimma,Omonada,70,17,75,162
Meskerem,1st,2010,Oromia,West Shewa,Tibe Kutaye,62,44,52,158
Meskerem,1st,2010,Oromia,North Shewa,Fiche Hospital,68,50,77,195
Ginbot,9th,2009,Oromia,Jimma,Kersa,76,80,29,185
Tir,5th,2010,Oromia,West Wellega,Babo Gembel,53,26,55,134
Tahesas,4th,2010,Oromia,West Wellega,Genji,27,12,42,81
Teqemt,2nd,2010,Oromia,East Wellega,Gida Ayana,89,36,71,196
Ginbot,9th,2010,Oromia,Horo Gudru Wellega,Abay Chomen,57,23,84,164
Tir,5th,2011,Oromia,West Shewa,Codi,65,92,38,195
Miyazia,8th,2010,Oromia,West Wellega,Gimbi Adventist Hospital,24,67,68,159
Hedar,3rd,2011,Oromia,West Wellega,Begi,21,73,77,171
Yekatit,6th,2010,Oromia,West Wellega,Gimbi,22,90,31,143
Tahesas,4th,2011,Oromia,East Shewa,Gimbichu,3,60,43,106
Nehase,12th,2009,Oromia,West Hararge,Gelemso Hospital,71,15,72,158
Ginbot,9th,2011,Oromia,Bale,Meda Welabu,29,42,45,116
Hedar,3rd,2010,Oromia,East Shewa,Batu,47,47,35,129
Tahesas,4th,2011,Oromia,Jimma,Setema,26,59,76,161
Tir,5th,2011,Oromia,Finfine Zuria,Sululta Town,51,84,1,136
Nehase,12th,2010,Oromia,West Guji,Suro Barguda,25,96,37,158
Megabit,7th,2010,Oromia,Guji,Shakiso Town,97,0,72,169
Tir,5th,2010,Oromia,Bale,Arena Buluq,9,92,52,153
Tahesas,4th,2011,Oromia,Borena,Dubluk,23,43,66,132
Tahesas,4th,2010,Oromia,East Shewa,Dugda,74,32,97,203
Miyazia,8th,2011,Oromia,Qeleme Wellega,Kake Hosp,35,34,92,161
Sene,10th,2011,Oromia,Buno Bedele,Dapho Hana,24,70,16,110
Nehase,12th,2010,Oromia,Guji,Anna Sora,45,20,20,85
Ginbot,9th,2009,Oromia,Arsi,Seru,1,71,89,161
Hedar,3rd,2010,Oromia,East Hararge,Bisidimo Hospital,91,90,75,256
Sene,10th,2010,Oromia,East Hararge,Aweday Town,33,59,92,184
Hamle,11th,2010,Oromia,Guji,Anna Sora,80,20,27,127
Miyazia,8th,2010,Oromia,Borena,Yabelo Hospital,15,95,96,206
Meskerem,1st,2010,Oromia,Ilu Aba Bora,Ale,54,15,31,100
Megabit,7th,2009,Oromia,Jimma,Nono Benja,7,55,30,92
Meskerem,1st,2010,Oromia,East Shewa,Batu,79,87,72,238
Miyazia,8th,2010,Oromia,Burayu Town,Burayu Town,24,71,59,154
Miyazia,8th,2011,Oromia,West Shewa,Dendi,68,69,34,171
Hedar,3rd,2011,Oromia,Bale,Ginir,2,72,91,165
Hedar,3rd,2011,Oromia,Guji,Gumi Eldallo,1,17,42,60
Meskerem,1st,2011,Oromia,East Shewa,Adama,1,88,84,173
Tir,5th,2011,Oromia,East Shewa,Gimbichu,41,92,51,184
Hamle,11th,2009,Oromia,East Hararge,Bisidimo Hospital,30,63,37,130
Miyazia,8th,2010,Oromia,Arsi,Chole,85,67,6,158
Tir,5th,2010,Oromia,East Shewa,Adama,78,93,69,240
Ginbot,9th,2011,Oromia,South West Shewa,Seden Sodo,54,55,28,137
Ginbot,9th,2011,Oromia,Jimma,Kersa,66,93,83,242
Ginbot,9th,2011,Oromia,Jimma,Chora Boter,8,52,49,109
Miyazia,8th,2010,Oromia,Borena,Dilo,16,26,59,101
Tahesas,4th,2010,Oromia,East Wellega,Gobu Seyo,6,59,23,88
Teqemt,2nd,2010,Oromia,East Wellega,Ebantu,20,18,87,125
Tahesas,4th,2011,Oromia,West Wellega,Mene Sibu,81,44,41,166
Meskerem,1st,2010,Oromia,East Hararge,Deder,49,72,15,136
Hamle,11th,2009,Oromia,Buno Bedele,Bedele Town,58,79,62,199
Hamle,11th,2009,Oromia,West Arsi,Kofele,26,25,60,111
Nehase,12th,2010,Oromia,East Hararge,Meyu Muleke,50,7,32,89
Megabit,7th,2010,Oromia,East Hararge,Melka Belo,16,81,27,124
Yekatit,6th,2009,Oromia,East Hararge,Gursum,5,12,30,47
Tir,5th,2010,Oromia,Bale,Gura Dhamole,70,42,40,152
Hedar,3rd,2011,Oromia,Jimma,Shabe,7,37,70,114
Teqemt,2nd,2010,Oromia,Finfine Zuria,Sandefa,73,38,44,155
Tahesas,4th,2010,Oromia,Buno Bedele,Bedele Hospital,60,2,99,161
Yekatit,6th,2009,Oromia,West Shewa,Tibe Kutaye,38,91,20,149
Ginbot,9th,2010,Oromia,Woliso Town,Woliso Town,46,20,85,151
Hedar,3rd,2010,Oromia,West Hararge,West Harerge	Gumbi Bordede,81,87,2,170
Yekatit,6th,2009,Oromia,Bale,Gololcha,25,98,34,157
Meskerem,1st,2011,Oromia,Finfine Zuria,Sandefa,51,20,94,165
Hamle,11th,2009,Oromia,West Shewa,Adea Berga,46,4,81,131
Miyazia,8th,2011,Oromia,Borena,Guchi,53,1,16,70
Nehase,12th,2009,Oromia,Bale,Goro,25,65,19,109
Miyazia,8th,2009,Oromia,Jimma Spe Town,Jimma Spe Town,57,22,41,120
Nehase,12th,2010,Oromia,Guji,Gumi Eldallo,22,36,91,149
Miyazia,8th,2011,Oromia,East Wellega,Haro Limu,53,23,96,172
Miyazia,8th,2010,Oromia,West Hararge,Oda Bultum,77,18,72,167
Nehase,12th,2010,Oromia,West Arsi,Kore,41,58,68,167
Megabit,7th,2010,Oromia,North Shewa,Hidabu Abote,18,88,64,170
Miyazia,8th,2011,Oromia,East Hararge,Deder Hospital,55,53,9,117
Tir,5th,2009,Oromia,South West Shewa,Woliso Town,4,91,92,187
Hamle,11th,2010,Oromia,Ilu Aba Bora,Nono Sele,41,48,89,178
Hedar,3rd,2011,Oromia,East Shewa,Batu,45,55,52,152
Tir,5th,2011,Oromia,East Shewa,Olanciti Hospital,94,89,64,247
Miyazia,8th,2009,Oromia,North Shewa,Girar Jarso,27,34,38,99
Hedar,3rd,2011,Oromia,West Arsi,Dodola Rural,7,47,20,74
Ginbot,9th,2010,Oromia,Ambo Town,Ambo Town,77,4,3,84
Megabit,7th,2010,Oromia,Guji,Adola Town,11,65,45,121
Megabit,7th,2010,Oromia,East Shewa,Matahara,77,50,82,209
Sene,10th,2009,Oromia,East Wellega,Haro Limu,90,9,75,174
Megabit,7th,2009,Oromia,Jimma,Guma,18,80,16,114
Tir,5th,2009,Oromia,Ilu Aba Bora,Doreni,76,11,76,163
Sene,10th,2009,Oromia,East Wellega,Sibu Sire,17,39,21,77
Nehase,12th,2010,Oromia,West Shewa,Bako Tibe,90,16,16,122
Ginbot,9th,2010,Oromia,North Shewa,Dera,91,16,52,159
Tahesas,4th,2010,Oromia,West Arsi,Arsi Negele Rural,82,33,80,195
Megabit,7th,2009,Oromia,Finfine Zuria,Akaki,1,95,81,177
Sene,10th,2011,Oromia,West Shewa,Tikur Enchini,40,80,50,170
Teqemt,2nd,2010,Oromia,Bale,Goro,49,47,69,165
Nehase,12th,2010,Oromia,Bishoftu Town,Bishoftu Town,94,8,9,111
Nehase,12th,2010,Oromia,West Shewa,Dendi,7,3,10,20
Teqemt,2nd,2011,Oromia,Ilu Aba Bora,Ale,55,7,63,125
Meskerem,1st,2011,Oromia,Ilu Aba Bora,Metu Town,59,83,59,201
Teqemt,2nd,2011,Oromia,Guji,Gumi Eldallo,97,32,67,196
Tahesas,4th,2010,Oromia,Borena,Arero,99,70,67,236
Tir,5th,2011,Oromia,West Shewa,Dendi,45,26,57,128
Tahesas,4th,2011,Oromia,West Shewa,Adea Berga,73,90,6,169
Sene,10th,2010,Oromia,West Shewa,Ambo,33,49,3,85
Nehase,12th,2010,Oromia,West Hararge,Chiro Town,9,5,77,91
Tir,5th,2011,Oromia,Guji,Shakiso Town,13,28,42,83
Miyazia,8th,2011,Oromia,Buno Bedele,Dedesa,48,73,98,219
Hamle,11th,2010,Oromia,West Hararge,Burka Dimtu,3,49,19,71
Megabit,7th,2011,Oromia,Qeleme Wellega,Laloqile,6,17,24,47
Megabit,7th,2010,Oromia,East Shewa,Adea,39,7,18,64
Hamle,11th,2009,Oromia,North Shewa,Degem,0,30,97,127
Ginbot,9th,2009,Oromia,Jimma,Seka Chekorsa,53,72,38,163
Yekatit,6th,2010,Oromia,West Wellega,Begi Hospital,32,38,78,148
Meskerem,1st,2011,Oromia,West Arsi,Kore,76,42,3,121
Hedar,3rd,2011,Oromia,West Wellega,Jarso,6,12,26,44
Yekatit,6th,2009,Oromia,West Wellega,Nejo Rural,33,68,14,115
Meskerem,1st,2011,Oromia,East Hararge,Aweday Town,52,1,40,93
Hamle,11th,2010,Oromia,West Shewa,Codi,67,26,17,110
Miyazia,8th,2009,Oromia,West Guji,Bule Hora Hospital,52,42,21,115
Ginbot,9th,2010,Oromia,West Shewa,Gedo Hospital,28,66,55,149
Sene,10th,2009,Oromia,South West Shewa,Ilu,96,57,19,172
Megabit,7th,2010,Oromia,Qeleme Wellega,Anfilo,64,43,39,146
Yekatit,6th,2011,Oromia,Qeleme Wellega,Sedan Chanka,25,83,8,116
Tir,5th,2010,Oromia,West Shewa,Nono,87,5,11,103
Meskerem,1st,2011,Oromia,Jimma,Sigmo,55,70,44,169
Tir,5th,2011,Oromia,Jimma,Setema Hospital,78,88,61,227
Teqemt,2nd,2011,Oromia,Borena,Teltele,94,3,12,109
Megabit,7th,2010,Oromia,West Hararge,Anchar,75,13,86,174
Meskerem,1st,2011,Oromia,West Wellega,Babo Gembel,87,66,85,238
Ginbot,9th,2010,Oromia,East Hararge,Girawa,43,62,24,129
Teqemt,2nd,2010,Oromia,Jimma,Sekoru,15,36,13,64
Meskerem,1st,2011,Oromia,East Hararge,Garemuleta Hospital,27,31,8,66
Megabit,7th,2011,Oromia,West Hararge,Guba Qoricha,19,25,77,121
Ginbot,9th,2009,Oromia,Bishoftu Town,Bishoftu Town,2,65,25,92
Meskerem,1st,2011,Oromia,North Shewa,Yaya Gulele,3,62,84,149
Yekatit,6th,2009,Oromia,Guji,Aga Wayyu,26,55,45,126
Miyazia,8th,2010,Oromia,Arsi,Bale Gesgara,48,78,34,160
Hamle,11th,2009,Oromia,West Shewa,Ambo Town,57,83,49,189
Megabit,7th,2010,Oromia,Ilu Aba Bora,Darimu,97,89,93,279
Hedar,3rd,2011,Oromia,West Arsi,Kokosa  Hospital,38,96,63,197
Tahesas,4th,2010,Oromia,Bale,Legehida,41,11,53,105
Hedar,3rd,2010,Oromia,Borena,Dilo,3,51,97,151
Megabit,7th,2009,Oromia,Horo Gudru Wellega,Abay Chomen,63,1,79,143
Yekatit,6th,2010,Oromia,West Guji,Kercha,87,18,17,122
Ginbot,9th,2011,Oromia,West Hararge,Tulo,17,1,41,59
Tir,5th,2011,Oromia,Borena,Guchi,5,37,66,108
Hedar,3rd,2010,Oromia,South West Shewa,Wonchi,67,4,0,71
Tahesas,4th,2011,Oromia,Finfine Zuria,Akaki,28,22,70,120
Tir,5th,2010,Oromia,West Hararge,Hawi Gudina,36,63,93,192
Teqemt,2nd,2010,Oromia,East Shewa,Lomme,83,34,7,124
Yekatit,6th,2010,Oromia,Arsi,Ludehetosa,40,62,68,170
Tir,5th,2009,Oromia,Dukem Town,Dukem Town,86,39,2,127
Meskerem,1st,2010,Oromia,West Shewa,Ambo Town,64,32,54,150
Teqemt,2nd,2010,Oromia,Guji,Aga Wayyu,54,99,53,206
Tahesas,4th,2010,Oromia,West Wellega,Jarso,50,15,8,73
Miyazia,8th,2010,Oromia,Qeleme Wellega,Hawa Gelan,43,94,11,148
Yekatit,6th,2011,Oromia,Arsi,Tiyo,79,86,61,226
Tir,5th,2009,Oromia,West Wellega,Gimbi Public  Hospital,75,82,43,200
Tahesas,4th,2011,Oromia,Bale,Legehida,51,36,48,135
Tahesas,4th,2010,Oromia,Qeleme Wellega,Dambi Dollo,73,50,9,132
Yekatit,6th,2011,Oromia,East Hararge,Deder,0,38,89,127
Miyazia,8th,2009,Oromia,East Shewa,Dugda,73,40,13,126
Teqemt,2nd,2010,Oromia,Qeleme Wellega,Laloqile,59,51,39,149
Tahesas,4th,2011,Oromia,East Shewa,Olanciti Hospital,88,41,36,165
Hamle,11th,2009,Oromia,West Guji,Bule Hora Toun,88,62,3,153
Yekatit,6th,2009,Oromia,West Wellega,Mene Sibu,36,42,56,134
Ginbot,9th,2009,Oromia,West Wellega,Nejo Rural,0,37,80,117
Nehase,12th,2009,Oromia,Bale,Dawe Qachen,6,14,55,75
Ginbot,9th,2009,Oromia,Guji,Shakiso Town,77,30,69,176
Ginbot,9th,2011,Oromia,Buno Bedele,Boricha,12,76,2,90
Nehase,12th,2010,Oromia,Borena,Meyo,91,41,38,170
Miyazia,8th,2009,Oromia,Guji,Adola Hospital,38,77,78,193
Megabit,7th,2010,Oromia,West Wellega,Kundala,26,70,72,168
Miyazia,8th,2011,Oromia,Woliso Town,Woliso Town,85,82,60,227
Sene,10th,2009,Oromia,Jimma,Dedo,95,8,21,124
Megabit,7th,2010,Oromia,East Shewa,Gimbichu,58,35,26,119
Yekatit,6th,2011,Oromia,Bale,Berbere,21,21,38,80
Tir,5th,2010,Oromia,East Shewa,Batu,77,72,42,191
Nehase,12th,2009,Oromia,Qeleme Wellega,Seyo,4,60,98,162
Megabit,7th,2010,Oromia,Qeleme Wellega,Dale Sedi,22,91,45,158
Yekatit,6th,2011,Oromia,East Hararge,Babile,17,12,2,31
Sene,10th,2009,Oromia,Jimma,Limu Seka,72,76,21,169
Yekatit,6th,2010,Oromia,West Shewa,Ginde Beret,10,68,84,162
Yekatit,6th,2009,Oromia,East Hararge,Aweday Town,8,15,15,38
Teqemt,2nd,2010,Oromia,Guji,Wadara,1,7,37,45
Tir,5th,2011,Oromia,West Arsi,Loke Hada Hospital,18,91,36,145
Yekatit,6th,2010,Oromia,West Hararge,Burka Dimtu,47,66,86,199
Miyazia,8th,2009,Oromia,Bale,Gura Dhamole,78,93,28,199
Ginbot,9th,2011,Oromia,North Shewa,Dera Hospital,59,24,76,159
Miyazia,8th,2010,Oromia,Arsi,Tena,47,19,59,125
Nehase,12th,2010,Oromia,Arsi,Merti,94,66,14,174
Tahesas,4th,2010,Oromia,Guji,Gumi Eldallo,12,83,42,137
Miyazia,8th,2009,Oromia,East Wellega,Haro Limu,4,23,93,120
Teqemt,2nd,2010,Oromia,West Shewa,Jibat,23,12,82,117
Ginbot,9th,2011,Oromia,West Guji,Hanbala,96,59,56,211
Nehase,12th,2009,Oromia,Horo Gudru Wellega,Amuru,56,11,47,114
Megabit,7th,2010,Oromia,Jimma,Sekoru,69,74,53,196
Megabit,7th,2009,Oromia,Qeleme Wellega,Dambi Dollo,6,30,23,59
Tir,5th,2011,Oromia,West Shewa,Abuna Gindeberet,80,40,57,177
Tahesas,4th,2011,Oromia,Jimma,Tiro Afeta,53,29,58,140
Tir,5th,2010,Oromia,West Shewa,Ambo,88,69,96,253
Yekatit,6th,2010,Oromia,South West Shewa,Dawo,24,84,71,179
Tir,5th,2009,Oromia,East Shewa,Dugda,29,65,25,119
Yekatit,6th,2011,Oromia,East Shewa,Boset,30,72,39,141
Ginbot,9th,2009,Oromia,Bale,Ginir,75,60,21,156
Megabit,7th,2011,Oromia,Ilu Aba Bora,Algesachi,77,44,16,137
Ginbot,9th,2010,Oromia,Buno Bedele,Chora,25,21,48,94
Miyazia,8th,2009,Oromia,Borena,Dubluk,75,0,89,164
Yekatit,6th,2011,Oromia,East Hararge,Kurfa Chele,41,65,13,119
Ginbot,9th,2011,Oromia,East Hararge,Bedeno,51,82,36,169
Tir,5th,2009,Oromia,Jimma,Limu Hospital,57,7,70,134
Sene,10th,2011,Oromia,Horo Gudru Wellega,Horro Buluk,5,53,15,73
Miyazia,8th,2010,Oromia,East Hararge,Deder,24,30,83,137
Nehase,12th,2009,Oromia,Ilu Aba Bora,Bure,47,13,29,89
Yekatit,6th,2011,Oromia,East Hararge,Goro Muti,38,62,33,133
Miyazia,8th,2010,Oromia,East Shewa,Matahara,94,70,21,185
Sene,10th,2010,Oromia,West Shewa,Tibe Kutaye,48,9,40,97
Ginbot,9th,2009,Oromia,West Hararge,Tulo,56,70,89,215
Ginbot,9th,2011,Oromia,East Wellega,Wama Hagelo,2,21,82,105
Miyazia,8th,2011,Oromia,North Shewa,Hidabu Abote,35,82,5,122
Yekatit,6th,2010,Oromia,Woliso Town,Woliso Town,41,80,46,167
Miyazia,8th,2010,Oromia,East Hararge,Midega Tole,65,93,53,211
Miyazia,8th,2011,Oromia,West Wellega,Babo Gembel,68,39,49,156
Sene,10th,2009,Oromia,North Shewa,Jido,50,18,84,152
Tahesas,4th,2011,Oromia,Arsi,Bale Gesgara,37,83,57,177
Megabit,7th,2010,Oromia,West Hararge,Habro,35,59,11,105
Tir,5th,2009,Oromia,East Hararge,Kumbi,80,95,52,227
Megabit,7th,2009,Oromia,West Guji,Kercha,84,76,90,250
Tir,5th,2010,Oromia,West Arsi,Bishan Guracha Town,81,26,60,167
Ginbot,9th,2010,Oromia,Guji,Wadara,48,70,18,136
Hamle,11th,2010,Oromia,Buno Bedele,Meko,70,2,59,131
Hedar,3rd,2011,Oromia,Borena,Dilo,99,16,88,203
Miyazia,8th,2010,Oromia,West Shewa,Chelia,65,18,18,101
Hamle,11th,2010,Oromia,East Hararge,Kumbi,23,74,4,101
Megabit,7th,2011,Oromia,Borena,Dilo,74,20,54,148
Miyazia,8th,2010,Oromia,Arsi,Munesa,5,96,74,175
Ginbot,9th,2011,Oromia,West Hararge,Meiso,69,52,22,143
Miyazia,8th,2010,Oromia,Guji,Shakiso Town,13,62,12,87
Hedar,3rd,2010,Oromia,Borena,Yabelo Rural,43,66,52,161
Meskerem,1st,2011,Oromia,West Shewa,Guder Hosp,72,92,59,223
Hedar,3rd,2010,Oromia,Bale,Legehida,77,81,41,199
Miyazia,8th,2009,Oromia,Ilu Aba Bora,Darimu,16,16,75,107
Sene,10th,2010,Oromia,West Wellega,Ayira Hospital,97,39,18,154
Megabit,7th,2010,Oromia,Bale,Legehida,54,65,60,179
Tir,5th,2010,Oromia,Arsi,Seru,4,97,9,110
Meskerem,1st,2010,Oromia,Sululta Town,Sululta Town,90,5,39,134
Megabit,7th,2011,Oromia,Guji,Aga Wayyu,62,6,95,163
Teqemt,2nd,2011,Oromia,West Hararge,West Harerge	Gumbi Bordede,83,73,90,246
Sene,10th,2010,Oromia,Finfine Zuria,Sululta Town,84,85,14,183
Ginbot,9th,2009,Oromia,Qeleme Wellega,Dambi Dolo Hospital,41,94,19,154
Tahesas,4th,2011,Oromia,Jimma,Mancho,22,85,68,175
Yekatit,6th,2011,Oromia,Burayu Town,Burayu Town,74,74,55,203
Yekatit,6th,2009,Oromia,East Hararge,Aweday Town,11,23,95,129
Meskerem,1st,2011,Oromia,Borena,Guchi,77,38,17,132
Tir,5th,2011,Oromia,West Shewa,Abuna Gindeberet,73,92,59,224
Yekatit,6th,2009,Oromia,West Wellega,Seyo Nole,60,14,70,144
Teqemt,2nd,2010,Oromia,Bale,Gololcha,57,57,33,147
Nehase,12th,2010,Oromia,East Wellega,Boneya Bushe,22,22,28,72
Tir,5th,2010,Oromia,Borena,Yabelo Rural,86,80,17,183
Hedar,3rd,2010,Oromia,Horo Gudru Wellega,Jima Rare,4,75,60,139
Hedar,3rd,2011,Oromia,Nekemte Town,Nekemte Town,71,72,92,235
Ginbot,9th,2011,Oromia,East Hararge,Girawa,76,55,42,173
Hedar,3rd,2011,Oromia,East Hararge,Kombolicha,30,51,7,88
Yekatit,6th,2009,Oromia,Borena,Moyale Hospital,88,39,79,206
Hedar,3rd,2010,Oromia,Buno Bedele,Dedesa,70,22,20,112
Yekatit,6th,2009,Oromia,West Shewa,Codi,5,90,67,162
Sene,10th,2009,Oromia,East Hararge,Haromaya Hospital,43,23,97,163
Yekatit,6th,2009,Oromia,Qeleme Wellega,Anfilo,96,4,34,134
Tir,5th,2010,Oromia,West Wellega,Ayira Hospital,9,95,43,147
Sene,10th,2010,Oromia,Nekemte Town,Nekemte Town,66,6,24,96
Megabit,7th,2010,Oromia,West Guji,Suro Barguda,31,17,50,98
Sene,10th,2009,Oromia,West Wellega,Genji,0,5,20,25
Miyazia,8th,2009,Oromia,Arsi,Digeluna Tijo,56,25,1,82
Tir,5th,2010,Oromia,East Shewa,Bora,36,73,92,201
Meskerem,1st,2011,Oromia,Guji,Girja,23,60,72,155
Ginbot,9th,2010,Oromia,West Wellega,Ayira Hospital,21,86,48,155
Tir,5th,2009,Oromia,North Shewa,Were Jarso,16,2,38,56
Megabit,7th,2011,Oromia,Jimma,Dedo,3,18,98,119
Sene,10th,2010,Oromia,Arsi,Gololcha,77,36,5,118
Megabit,7th,2009,Oromia,Horo Gudru Wellega,Jima Rare,17,73,27,117
Hedar,3rd,2011,Oromia,Jimma,Limu Kosa,77,86,1,164
Teqemt,2nd,2010,Oromia,Guji,Anna Sora,26,44,30,100
Ginbot,9th,2009,Oromia,North Shewa,Aleiltu,66,61,23,150
Meskerem,1st,2011,Oromia,Guji,Bore Hospital,14,76,14,104
Miyazia,8th,2011,Oromia,Ilu Aba Bora,Nono Sele,98,50,0,148
Sene,10th,2011,Oromia,West Shewa,Bako Tibe,74,7,26,107
Nehase,12th,2010,Oromia,North Shewa,Debre Libanos,20,93,51,164
Sene,10th,2011,Oromia,West Arsi,Arsi Negele Town,57,53,56,166
Tahesas,4th,2011,Oromia,Horo Gudru Wellega,Jima Geneti,99,95,12,206
Ginbot,9th,2009,Oromia,Borena,Dire,38,55,4,97
Hamle,11th,2010,Oromia,Arsi,Guna,18,1,93,112
Nehase,12th,2010,Oromia,North Shewa,Kuyu Hospital,52,85,50,187
Megabit,7th,2011,Oromia,Jimma,Omo Nada Hospital,73,82,92,247
Meskerem,1st,2011,Oromia,West Wellega,Yubdo,74,16,2,92
Hedar,3rd,2011,Oromia,Arsi,Amigna,94,1,72,167
Miyazia,8th,2011,Oromia,Guji,Adola Hospital,14,24,49,87
Nehase,12th,2010,Oromia,East Hararge,Haromaya Town,36,21,83,140
Meskerem,1st,2011,Oromia,Guji,Negele Hospital,78,88,44,210
Megabit,7th,2010,Oromia,Bale,Legehida,31,41,64,136
Teqemt,2nd,2010,Oromia,Qeleme Wellega,Dambi Dolo Hospital,28,37,99,164
Tahesas,4th,2011,Oromia,West Hararge,Gemechis,56,43,7,106
Ginbot,9th,2011,Oromia,East Shewa,Liben,9,28,55,92
Megabit,7th,2011,Oromia,West Wellega,Begi Hospital,42,57,48,147
Miyazia,8th,2009,Oromia,East Wellega,Guto Gida,33,72,70,175
Miyazia,8th,2009,Oromia,Finfine Zuria,Sebeta Awas,23,45,66,134
Yekatit,6th,2010,Oromia,West Wellega,Jarso,79,80,58,217
Ginbot,9th,2011,Oromia,North Shewa,Abichugna,21,93,95,209
Nehase,12th,2010,Oromia,North Shewa,Degem,77,90,6,173
Tir,5th,2009,Oromia,Jimma,Shabe,87,98,71,256
Nehase,12th,2010,Oromia,Finfine Zuria,Akaki,72,96,40,208
Teqemt,2nd,2010,Oromia,North Shewa,Debre Libanos,12,8,99,119
Tir,5th,2010,Oromia,East Wellega,Jimma Arjo,51,19,46,116
Ginbot,9th,2011,Oromia,Jimma,Nono Benja,45,87,79,211
Sene,10th,2009,Oromia,West Wellega,Gimbi Public  Hospital,93,40,17,150
Hamle,11th,2009,Oromia,Arsi,Jeju,32,86,77,195
Teqemt,2nd,2011,Oromia,Arsi,Amigna,88,35,15,138
Meskerem,1st,2011,Oromia,West Hararge,Meiso,64,70,75,209
Sene,10th,2010,Oromia,Qeleme Wellega,Dambi Dolo Hospital,11,60,43,114
Meskerem,1st,2010,Oromia,West Hararge,Boke,45,60,38,143
Tir,5th,2009,Oromia,Arsi,Jeju,45,30,2,77
Megabit,7th,2009,Oromia,Borena,Yabelo,68,48,41,157
Sene,10th,2009,Oromia,West Guji,Bule Hora Hospital,70,7,40,117
Megabit,7th,2009,Oromia,Jimma,Seka Chekorsa,22,22,7,51
Sene,10th,2009,Oromia,North Shewa,Fiche Hospital,96,64,62,222
Sene,10th,2011,Oromia,East Shewa,Adama,11,67,43,121
Tahesas,4th,2010,Oromia,West Shewa,Gindeberet Hospital,45,61,58,164
Sene,10th,2009,Oromia,West Arsi,Dodola Town,0,35,56,91
Meskerem,1st,2011,Oromia,East Shewa,Adami Tulu Jido Kombolcha,99,11,29,139
Hamle,11th,2009,Oromia,East Hararge,Kumbi,33,55,33,121
Hedar,3rd,2011,Oromia,Robe Town,Robe Town,99,74,20,193
Hedar,3rd,2010,Oromia,West Arsi,Arsi Negele Town,58,53,9,120
Nehase,12th,2009,Oromia,South West Shewa,Goro,17,36,91,144
Nehase,12th,2009,Oromia,Bale,Legehida,25,32,79,136
Yekatit,6th,2010,Oromia,Sebeta Town,Sebeta Town,57,13,20,90
Megabit,7th,2009,Oromia,West Shewa,Adea Berga,6,93,34,133
Ginbot,9th,2011,Oromia,South West Shewa,Woliso Rural,30,77,59,166
Miyazia,8th,2009,Oromia,Jimma,B/Tolyi,64,36,29,129
Hamle,11th,2009,Oromia,Bale,Sinana,23,35,27,85
Sene,10th,2010,Oromia,West Arsi,Hebal Arsi,25,39,44,108
Ginbot,9th,2010,Oromia,Arsi,Amigna,92,19,12,123
Megabit,7th,2010,Oromia,Horo Gudru Wellega,Abe Dengoro,3,15,21,39
Megabit,7th,2010,Oromia,West Shewa,Ambo Hospital,20,42,53,115
Megabit,7th,2010,Oromia,Arsi,Chole,57,22,71,150
Tir,5th,2010,Oromia,West Wellega,Mendi Hospital,92,66,18,176
Teqemt,2nd,2011,Oromia,North Shewa,Wuchale,75,55,18,148
Meskerem,1st,2010,Oromia,West Wellega,Lata Sibu,13,84,68,165
Teqemt,2nd,2010,Oromia,East Wellega,Diga,75,66,95,236
Sene,10th,2010,Oromia,Qeleme Wellega,Hawa Gelan,7,95,31,133
Ginbot,9th,2010,Oromia,West Shewa,Tikur Enchini,20,48,95,163
Hedar,3rd,2010,Oromia,West Arsi,Kokosa,92,99,17,208
Tir,5th,2010,Oromia,West Arsi,Arsi Negele Town,70,13,41,124
Tir,5th,2009,Oromia,North Shewa,Jido,39,28,33,100
Ginbot,9th,2010,Oromia,Qeleme Wellega,Dale Wabera,41,85,43,169
Hedar,3rd,2010,Oromia,South West Shewa,Goro,3,78,40,121
Ginbot,9th,2011,Oromia,Ilu Aba Bora,Algesachi,82,89,39,210
Miyazia,8th,2011,Oromia,West Hararge,Habro,5,25,19,49
Megabit,7th,2011,Oromia,Guji,Saba Boru,23,52,45,120
Hamle,11th,2009,Oromia,Guji,Aga Wayyu,49,69,46,164
Meskerem,1st,2010,Oromia,West Wellega,Babo Gembel,59,50,88,197
Megabit,7th,2010,Oromia,West Shewa,Codi,80,98,88,266
Miyazia,8th,2010,Oromia,South West Shewa,Goro,69,32,94,195
Nehase,12th,2010,Oromia,Ilu Aba Bora,Yayu,97,64,50,211
Sene,10th,2010,Oromia,Arsi,Bekoji Town,15,33,32,80
Tir,5th,2011,Oromia,Jimma Spe Town,Jimma Spe Town,32,77,66,175
Yekatit,6th,2011,Oromia,West Wellega,Nejo Town,2,6,11,19
Hamle,11th,2010,Oromia,West Arsi,Dodola Town,22,45,13,80
Sene,10th,2010,Oromia,Horo Gudru Wellega,Shambu Town,45,35,12,92
Ginbot,9th,2011,Oromia,Arsi,Aseko,4,41,74,119
Hedar,3rd,2010,Oromia,West Arsi,Siraro,73,30,15,118
Tir,5th,2011,Oromia,North Shewa,Kuyu,68,91,13,172
Teqemt,2nd,2010,Oromia,West Arsi,Gedeb Asasa,68,49,81,198
Tir,5th,2011,Oromia,West Arsi,Dodola Town,7,72,79,158
Yekatit,6th,2010,Oromia,Arsi,Chole,79,88,44,211
Nehase,12th,2010,Oromia,East Wellega,Wama Hagelo,73,61,8,142
Megabit,7th,2011,Oromia,East Wellega,Leqa Dulecha,74,48,18,140
Hedar,3rd,2010,Oromia,East Shewa,Liben,65,41,68,174
Yekatit,6th,2011,Oromia,South West Shewa,Wonchi,44,27,95,166
Miyazia,8th,2010,Oromia,Arsi,Bale Gesgara,14,19,68,101
Nehase,12th,2010,Oromia,West Wellega,Mene Sibu,84,3,24,111
Meskerem,1st,2011,Oromia,Bale,Gololcha,87,41,69,197
Ginbot,9th,2010,Oromia,Jimma,Guma,97,56,50,203
Yekatit,6th,2011,Oromia,Horo Gudru Wellega,Hababo Guduru,1,60,83,144
Teqemt,2nd,2010,Oromia,East Hararge,Bedeno,73,55,14,142
Ginbot,9th,2009,Oromia,West Shewa,Ginde Beret,22,54,2,78
Tahesas,4th,2011,Oromia,East Wellega,Haro Limu,35,66,48,149
Megabit,7th,2009,Oromia,West Shewa,Nono,11,13,77,101
Tir,5th,2009,Oromia,West Shewa,Midakegni,63,42,30,135
Nehase,12th,2010,Oromia,Ilu Aba Bora,Becho,57,16,53,126
Sene,10th,2011,Oromia,West Arsi,Kokosa  Hospital,99,57,76,232
Megabit,7th,2011,Oromia,West Wellega,Lalo Asabi,5,81,95,181
Megabit,7th,2010,Oromia,Arsi,Bale Gesgara,62,56,52,170
Tir,5th,2009,Oromia,West Hararge,Gemechis,88,47,51,186
Tahesas,4th,2011,Oromia,Guji,Adola Town,72,40,64,176
Ginbot,9th,2011,Oromia,West Arsi,Hebal Arsi,46,99,82,227
Hamle,11th,2009,Oromia,West Shewa,Abuna Gindeberet,56,36,74,166
Ginbot,9th,2011,Oromia,Arsi,Robe,42,56,77,175
Sene,10th,2011,Oromia,Arsi,Deksis,94,44,95,233
Megabit,7th,2011,Oromia,West Guji,Biebirsa Kojowa,6,70,19,95
Sene,10th,2009,Oromia,Ilu Aba Bora,Yayu,16,99,76,191
Miyazia,8th,2011,Oromia,Buno Bedele,Boricha,32,70,88,190
Hedar,3rd,2010,Oromia,Lege Dadi Lege Tafo Town,Lege Dadi Lege Tafo Town,51,53,53,157
Hedar,3rd,2010,Oromia,Borena,El Way,28,70,87,185
Ginbot,9th,2010,Oromia,North Shewa,Were Jarso,23,8,5,36
Meskerem,1st,2010,Oromia,Arsi,Hitosa,22,81,47,150
Megabit,7th,2010,Oromia,Bale,Gasera,22,22,64,108
Megabit,7th,2009,Oromia,Bale,Berbere,18,15,21,54
Miyazia,8th,2010,Oromia,West Hararge,Oda Bultum,14,69,23,106
Teqemt,2nd,2010,Oromia,Bale,Gasera,18,16,38,72
Teqemt,2nd,2011,Oromia,Horo Gudru Wellega,Hababo Guduru,23,83,23,129
Ginbot,9th,2011,Oromia,West Hararge,Doba,1,59,80,140
Miyazia,8th,2010,Oromia,East Wellega,Jimma Arjo,17,17,4,38
Hamle,11th,2009,Oromia,Jimma,Agaro,45,5,91,141
Sene,10th,2009,Oromia,East Hararge,Fedis,79,33,64,176
Tir,5th,2010,Oromia,Borena,Yabelo Rural,52,41,82,175
Teqemt,2nd,2011,Oromia,East Hararge,Aweday Town,52,25,51,128
Sene,10th,2010,Oromia,Bale,Raitu,59,98,75,232
Hamle,11th,2009,Oromia,East Wellega,Gobu Seyo,79,2,17,98
Miyazia,8th,2010,Oromia,East Shewa,Adea,65,64,33,162
Tir,5th,2009,Oromia,Qeleme Wellega,Gawo Qebe,69,71,27,167
Tir,5th,2010,Oromia,Finfine Zuria,Sululta Town,39,49,63,151
Teqemt,2nd,2011,Oromia,Horo Gudru Wellega,Horo,54,41,57,152
Nehase,12th,2010,Oromia,Arsi,Enkelo Wabe,86,53,21,160
Nehase,12th,2009,Oromia,Buno Bedele,Dedesa,69,63,97,229
Sene,10th,2009,Oromia,East Hararge,Kurfa Chele,32,4,46,82
Megabit,7th,2010,Oromia,Arsi,Shirka,86,60,62,208
Sene,10th,2010,Oromia,West Shewa,Gedo Hospital,78,86,76,240
Ginbot,9th,2011,Oromia,Ilu Aba Bora,Bure,0,45,48,93
Megabit,7th,2009,Oromia,Jimma,Mancho,43,83,79,205
Meskerem,1st,2010,Oromia,Horo Gudru Wellega,Jima Geneti,1,49,44,94
Tir,5th,2009,Oromia,Ilu Aba Bora,Doreni,88,54,74,216
Tir,5th,2010,Oromia,Qeleme Wellega,Dale Sedi,70,49,82,201
Megabit,7th,2009,Oromia,East Wellega,Wayu Tuqa,0,74,8,82
Miyazia,8th,2010,Oromia,Arsi,Tiyo,54,41,48,143
Megabit,7th,2011,Oromia,East Wellega,Diga,74,58,38,170
Miyazia,8th,2009,Oromia,Horo Gudru Wellega,Abe Dengoro,6,63,98,167
Tir,5th,2009,Oromia,West Hararge,Chiro Zuriya,75,20,99,194
Hamle,11th,2010,Oromia,South West Shewa,Seden Sodo,47,16,65,128
Sene,10th,2009,Oromia,Qeleme Wellega,Gawo Qebe,85,0,45,130
Meskerem,1st,2010,Oromia,Qeleme Wellega,Dale Wabera,64,63,70,197
Nehase,12th,2010,Oromia,Horo Gudru Wellega,Horro Buluk,79,60,39,178
Miyazia,8th,2009,Oromia,Guji,Uraga,71,8,6,85
Tir,5th,2010,Oromia,Jimma,Gera,3,8,93,104
Tahesas,4th,2011,Oromia,Arsi,Zeway Dugda,65,42,12,119
Megabit,7th,2010,Oromia,West Arsi,Hebal Arsi,29,75,30,134
Tir,5th,2010,Oromia,West Wellega,Babo Gembel,27,35,90,152
Ginbot,9th,2011,Oromia,Qeleme Wellega,Laloqile,34,73,42,149
Yekatit,6th,2009,Oromia,East Wellega,Leqa Dulecha,73,30,10,113
Nehase,12th,2010,Oromia,Bale,Ginir Town,76,11,37,124
Sene,10th,2011,Oromia,East Hararge,Chinakesen,65,51,85,201
Tir,5th,2010,Oromia,Qeleme Wellega,Gawo Qebe,94,40,56,190
Sene,10th,2009,Oromia,West Hararge,Meiso,8,96,97,201
Nehase,12th,2010,Oromia,North Shewa,Abichugna,22,70,75,167
Tir,5th,2009,Oromia,West Wellega,Genji,44,81,38,163
Tir,5th,2010,Oromia,Bale,Dinsho,89,78,36,203
Tir,5th,2009,Oromia,Gelan Town,Gelan Town,71,50,14,135
Tir,5th,2011,Oromia,Finfine Zuria,Sebeta Awas,15,4,18,37
Tir,5th,2010,Oromia,Borena,Yabelo Rural,40,60,70,170
Nehase,12th,2009,Oromia,West Arsi,Gambo Hospital,57,6,45,108
Tahesas,4th,2011,Oromia,West Shewa,Ambo,54,11,11,76
Meskerem,1st,2010,Oromia,West Hararge,Chiro Town,49,73,0,122
Ginbot,9th,2011,Oromia,Arsi,Digeluna Tijo,49,32,68,149
Hamle,11th,2009,Oromia,Arsi,Deksis,33,25,55,113
Hedar,3rd,2011,Oromia,West Wellega,Genji,1,53,54,108
Nehase,12th,2010,Oromia,East Hararge,Haromaya Rural,90,14,76,180
Sene,10th,2011,Oromia,West Hararge,Chiro Zuriya,71,13,53,137
Miyazia,8th,2009,Oromia,Ilu Aba Bora,Ale,44,76,6,126
Tahesas,4th,2010,Oromia,Buno Bedele,Boricha,68,25,80,173
Miyazia,8th,2011,Oromia,East Wellega,Boneya Bushe,88,85,10,183
Hedar,3rd,2011,Oromia,East Hararge,Haromaya Town,5,71,11,87
Hamle,11th,2009,Oromia,West Shewa,Jeldu,78,46,23,147
Hamle,11th,2009,Oromia,Guji,Saba Boru,40,88,59,187
Meskerem,1st,2011,Oromia,East Wellega,Gida Ayana,30,93,75,198
Ginbot,9th,2010,Oromia,Ilu Aba Bora,Hurumu,70,69,7,146
Tir,5th,2009,Oromia,West Guji,Dugda Dawa,86,97,45,228
Miyazia,8th,2011,Oromia,South West Shewa,Becho,70,10,51,131
Miyazia,8th,2011,Oromia,South West Shewa,Sodo Dac'Ha,98,61,20,179
Meskerem,1st,2010,Oromia,Buno Bedele,Dedesa,22,87,4,113
Miyazia,8th,2011,Oromia,North Shewa,Dera,66,92,19,177
Teqemt,2nd,2010,Oromia,West Shewa,Meta Waliqite,14,83,80,177
Megabit,7th,2010,Oromia,East Hararge,Haromaya Hospital,6,48,64,118
Tir,5th,2009,Oromia,West Wellega,Jarso,24,61,78,163
Teqemt,2nd,2011,Oromia,South West Shewa,Bantu  Hospital,53,14,40,107
Miyazia,8th,2010,Oromia,Arsi,Limuna Bilbilo,26,79,96,201
Hedar,3rd,2011,Oromia,West Hararge,Mesela,81,72,13,166
Tahesas,4th,2010,Oromia,Arsi,Deksis,33,94,15,142
Tahesas,4th,2010,Oromia,West Shewa,Codi,36,16,79,131
Sene,10th,2009,Oromia,East Shewa,Olanciti Hospital,48,69,91,208
Yekatit,6th,2010,Oromia,Jimma,Mana,65,21,28,114
Nehase,12th,2009,Oromia,West Hararge,Boke,37,5,13,55
Sene,10th,2011,Oromia,South West Shewa,Kersana Malima,26,66,22,114
Miyazia,8th,2009,Oromia,East Wellega,Leqa Dulecha,96,42,39,177
Megabit,7th,2011,Oromia,East Hararge,Haromaya Rural,52,81,33,166
Tir,5th,2009,Oromia,East Wellega,Boneya Bushe,53,5,19,77
Yekatit,6th,2011,Oromia,Jimma,Nono Benja,86,19,63,168
Teqemt,2nd,2011,Oromia,Jimma,Sekoru,40,71,92,203
Ginbot,9th,2011,Oromia,Bale,Sinana,93,18,63,174
Miyazia,8th,2009,Oromia,West Wellega,Seyo Nole,65,50,41,156
Teqemt,2nd,2010,Oromia,Bishoftu Town,Bishoftu Town,60,81,14,155
Nehase,12th,2010,Oromia,Jimma,Setema Hospital,82,23,91,196
Hamle,11th,2009,Oromia,Guji,Negele Hospital,44,44,9,97
Teqemt,2nd,2011,Oromia,Borena,Arero,85,5,8,98
Nehase,12th,2009,Oromia,Arsi,Bale Gesgara,4,5,15,24
Teqemt,2nd,2011,Oromia,East Hararge,Chinakesen,92,34,56,182
Yekatit,6th,2009,Oromia,Buno Bedele,Boricha,51,23,22,96
Tir,5th,2011,Oromia,West Shewa,Midakegni,3,7,76,86
Sene,10th,2010,Oromia,Finfine Zuria,Walmera,63,93,28,184
Ginbot,9th,2011,Oromia,Borena,Gomole,22,83,65,170
Meskerem,1st,2011,Oromia,West Hararge,Gemechis,96,33,45,174
Teqemt,2nd,2010,Oromia,West Wellega,Boji Cheqorsa,94,0,45,139
Teqemt,2nd,2011,Oromia,East Hararge,Garemuleta Hospital,62,60,24,146
Nehase,12th,2010,Oromia,Guji,Uraga,67,54,0,121
Nehase,12th,2010,Oromia,West Wellega,Mendi Town,3,97,45,145
Hamle,11th,2010,Oromia,West Hararge,West Harerge	Gumbi Bordede,46,69,64,179
Ginbot,9th,2011,Oromia,North Shewa,Wuchale,21,6,91,118
Megabit,7th,2010,Oromia,West Wellega,Gimbi Public  Hospital,39,74,95,208
Miyazia,8th,2010,Oromia,West Arsi,Hebal Arsi,25,88,44,157
Hamle,11th,2009,Oromia,West Wellega,Seyo Nole,26,97,13,136
Yekatit,6th,2009,Oromia,Finfine Zuria,Sululta Town,82,15,68,165
Megabit,7th,2011,Oromia,Jimma,Seka Chhokorsa Hospital,57,30,8,95
Megabit,7th,2009,Oromia,West Arsi,Shala,29,0,54,83
Hedar,3rd,2011,Oromia,South West Shewa,Wonchi,26,31,16,73
Nehase,12th,2009,Oromia,West Arsi,Siraro,64,4,28,96
Tir,5th,2011,Oromia,Jimma,Tiro Afeta,48,59,11,118
Meskerem,1st,2011,Oromia,Buno Bedele,Diga,47,32,43,122
Nehase,12th,2009,Oromia,East Shewa,Mojo,1,16,27,44
Ginbot,9th,2011,Oromia,Borena,Dilo,46,83,0,129
Ginbot,9th,2010,Oromia,West Wellega,Nejo Rural,92,71,17,180
Tahesas,4th,2010,Oromia,Guji,Anna Sora,9,66,84,159
Yekatit,6th,2011,Oromia,East Hararge,Midega Tole,66,61,65,192
Hedar,3rd,2011,Oromia,East Shewa,Matahara,79,61,45,185
Megabit,7th,2011,Oromia,West Arsi,Adaba,23,47,47,117
Hedar,3rd,2010,Oromia,West Arsi,Kokosa,93,96,24,213
Meskerem,1st,2011,Oromia,West Shewa,Meta Waliqite,36,33,27,96
Megabit,7th,2009,Oromia,Arsi,Chole,90,55,74,219
Miyazia,8th,2011,Oromia,East Shewa,Batu,96,31,61,188
Hamle,11th,2010,Oromia,Bale,Gasera,14,92,13,119
Meskerem,1st,2011,Oromia,Guji,Bore Hospital,11,64,11,86
Teqemt,2nd,2010,Oromia,Jimma,Nono Benja,74,84,88,246
Hamle,11th,2010,Oromia,Jimma,Gomma,87,24,53,164
Megabit,7th,2010,Oromia,West Hararge,Oda Bultum,77,60,37,174
Miyazia,8th,2011,Oromia,West Wellega,Mendi Hospital,13,69,17,99
Teqemt,2nd,2010,Oromia,East Wellega,Sasiga,40,29,34,103
Tir,5th,2009,Oromia,East Wellega,Diga,98,46,45,189
Megabit,7th,2009,Oromia,East Hararge,Melka Belo,80,21,83,184
Hedar,3rd,2010,Oromia,Horo Gudru Wellega,Horro Buluk,57,91,61,209
Nehase,12th,2010,Oromia,Jimma,Seka Chekorsa,74,31,21,126
Ginbot,9th,2010,Oromia,Ilu Aba Bora,Yayu,82,74,33,189
Sene,10th,2009,Oromia,Finfine Zuria,Berreh,38,47,83,168
Miyazia,8th,2011,Oromia,West Arsi,Siraro,15,19,7,41
Miyazia,8th,2010,Oromia,East Hararge,Kurfa Chele,69,56,12,137
Hedar,3rd,2011,Oromia,East Hararge,Fedis,21,89,8,118
Ginbot,9th,2010,Oromia,East Wellega,Wayu Tuqa,2,21,40,63
Nehase,12th,2010,Oromia,Ilu Aba Bora,Becho,43,17,86,146
Hedar,3rd,2011,Oromia,East Wellega,Sibu Sire,29,53,35,117
Tir,5th,2011,Oromia,East Wellega,Gobu Seyo,16,22,6,44
Tir,5th,2010,Oromia,Finfine Zuria,Sandefa,34,70,20,124
Yekatit,6th,2010,Oromia,Bale,Meda Welabu,49,31,27,107
Yekatit,6th,2010,Oromia,East Shewa,Adea,38,91,39,168
Miyazia,8th,2009,Oromia,Ilu Aba Bora,Hurumu,58,30,96,184
Meskerem,1st,2011,Oromia,West Shewa,Ambo,86,57,54,197
Yekatit,6th,2010,Oromia,East Hararge,Babile Woreda,34,50,69,153
Ginbot,9th,2009,Oromia,West Wellega,Jarso,53,84,69,206
Miyazia,8th,2010,Oromia,Guji,Shakiso Town,61,84,28,173
Tir,5th,2009,Oromia,Qeleme Wellega,Dambi Dolo Hospital,26,5,3,34
Miyazia,8th,2010,Oromia,North Shewa,Fichetown,39,8,39,86
Nehase,12th,2010,Oromia,South West Shewa,Goro,13,6,8,27
Yekatit,6th,2011,Oromia,North Shewa,Wuchale,92,78,64,234
Hamle,11th,2010,Oromia,East Wellega,Wama Hagelo,31,90,55,176
Yekatit,6th,2009,Oromia,North Shewa,Degem,15,52,39,106
Tir,5th,2011,Oromia,West Hararge,Chiro Town,47,46,82,175
Miyazia,8th,2010,Oromia,Ilu Aba Bora,Bure,9,69,16,94
Megabit,7th,2010,Oromia,West Shewa,Tibe Kutaye,25,26,58,109
Teqemt,2nd,2011,Oromia,Adama Special Town,Adama Town,48,63,69,180
Miyazia,8th,2010,Oromia,West Shewa,Tikur Enchini,58,53,11,122
Miyazia,8th,2010,Oromia,East Shewa,Lomme,53,29,90,172
Yekatit,6th,2009,Oromia,West Arsi,Kore,35,23,69,127
Meskerem,1st,2010,Oromia,Bale,Gura Dhamole,45,51,73,169
Meskerem,1st,2011,Oromia,Jimma,Kersa,97,91,21,209
Yekatit,6th,2010,Oromia,West Hararge,Burka Dimtu,19,36,63,118
Miyazia,8th,2011,Oromia,West Shewa,Dendi,14,22,83,119
Sene,10th,2009,Oromia,West Shewa,Ejersa Lafo,59,14,72,145
Tir,5th,2010,Oromia,Gelan Town,Gelan Town,96,60,44,200
Hamle,11th,2010,Oromia,Bale,Dinsho,98,65,33,196
Hedar,3rd,2011,Oromia,Guji,Negele Hospital,92,18,26,136
Tahesas,4th,2010,Oromia,West Hararge,Oda Bultum,52,97,13,162
Tir,5th,2011,Oromia,North Shewa,Kuyu Hospital,65,96,77,238
Hamle,11th,2009,Oromia,West Wellega,Lalo Asabi,49,90,11,150
Ginbot,9th,2011,Oromia,East Hararge,Garemuleta Hospital,5,62,89,156
Nehase,12th,2009,Oromia,North Shewa,Wuchale,74,25,6,105
Ginbot,9th,2011,Oromia,West Wellega,Jarso,93,12,48,153
Tir,5th,2011,Oromia,West Wellega,Nejo Hospital,19,39,96,154
Megabit,7th,2009,Oromia,East Hararge,Gursum,2,49,98,149
Tahesas,4th,2011,Oromia,West Hararge,Meiso,35,45,23,103
Megabit,7th,2010,Oromia,North Shewa,Wuchale,53,34,27,114
Yekatit,6th,2010,Oromia,Ilu Aba Bora,Bilonopa,1,7,63,71
Hamle,11th,2009,Oromia,East Hararge,Meta,55,31,94,180
Teqemt,2nd,2010,Oromia,Arsi,Munesa,10,92,9,111
Miyazia,8th,2010,Oromia,West Wellega,Boji Dermeji,54,29,81,164
Megabit,7th,2009,Oromia,West Shewa,Gojo Hospital,18,50,98,166
Tir,5th,2011,Oromia,North Shewa,Fichetown,70,54,20,144
Tir,5th,2010,Oromia,West Shewa,Gedo Hospital,39,41,67,147
Tir,5th,2009,Oromia,East Shewa,Bora,90,7,79,176
Hedar,3rd,2011,Oromia,West Arsi,Nensebo,12,23,12,47
Hedar,3rd,2011,Oromia,South West Shewa,Ameya Hospital,44,44,99,187
Miyazia,8th,2009,Oromia,Arsi,Aseko,14,92,22,128
Hamle,11th,2009,Oromia,Bale,Berbere,3,22,50,75
Miyazia,8th,2010,Oromia,Jimma,Kersa,10,34,64,108
Yekatit,6th,2010,Oromia,Finfine Zuria,Akaki,52,46,92,190
Nehase,12th,2010,Oromia,East Hararge,Babile,74,27,92,193
Nehase,12th,2010,Oromia,South West Shewa,Kersana Malima,32,4,4,40
Tir,5th,2011,Oromia,West Wellega,Boji Cheqorsa,77,22,4,103
Nehase,12th,2009,Oromia,Arsi,Tena,95,40,81,216
Tahesas,4th,2010,Oromia,West Shewa,Jibat,6,95,70,171
Miyazia,8th,2011,Oromia,West Arsi,Kore,89,47,41,177
Sene,10th,2010,Oromia,West Arsi,Kokosa,30,27,93,150
Hedar,3rd,2011,Oromia,North Shewa,Girar Jarso,16,25,95,136
Ginbot,9th,2009,Oromia,West Wellega,Haru,99,44,25,168
Tir,5th,2010,Oromia,East Hararge,Babile Woreda,45,83,27,155
Nehase,12th,2009,Oromia,West Wellega,Ayira,89,45,97,231
Yekatit,6th,2009,Oromia,West Shewa,Gojo Hospital,31,20,75,126
Nehase,12th,2010,Oromia,South West Shewa,Ameya,25,76,39,140
Ginbot,9th,2011,Oromia,Guji,Adola Reda,88,8,27,123
Ginbot,9th,2011,Oromia,Arsi,Tena,56,57,55,168
Nehase,12th,2010,Oromia,Arsi,Munesa,45,70,41,156
Megabit,7th,2010,Oromia,East Shewa,Olanciti Hospital,72,17,46,135
Yekatit,6th,2011,Oromia,East Wellega,Jimma Arjo,79,91,70,240
Hamle,11th,2010,Oromia,Qeleme Wellega,Seyo,99,11,69,179
Sene,10th,2010,Oromia,West Guji,Gelana,99,69,39,207
Hedar,3rd,2011,Oromia,West Shewa,Midakegni,42,13,77,132
Hamle,11th,2009,Oromia,East Hararge,Deder Hospital,23,83,61,167
Tir,5th,2011,Oromia,East Shewa,Adama,89,81,42,212
Tir,5th,2011,Oromia,West Hararge,Habro,19,14,55,88
Sene,10th,2010,Oromia,East Hararge,Aweday Town,70,45,24,139
Hamle,11th,2010,Oromia,West Shewa,Inchini Hospital,89,56,42,187
Miyazia,8th,2011,Oromia,East Shewa,Adama,51,13,80,144
Tahesas,4th,2010,Oromia,West Hararge,Oda Bultum,57,35,28,120
Megabit,7th,2009,Oromia,Guji,Dima,18,30,64,112
Megabit,7th,2010,Oromia,West Shewa,Jeldu,5,1,70,76
Ginbot,9th,2011,Oromia,East Wellega,Gida Ayana,38,53,40,131
Tahesas,4th,2011,Oromia,West Shewa,Ginde Beret,92,94,53,239
Ginbot,9th,2011,Oromia,West Wellega,Gimbi Rural,2,28,89,119
Tahesas,4th,2010,Oromia,West Guji,Bule Hora,34,31,46,111
Megabit,7th,2010,Oromia,East Hararge,Bedeno,57,52,67,176
Hamle,11th,2009,Oromia,West Shewa,Tibe Kutaye,35,90,99,224
Meskerem,1st,2011,Oromia,Bale,Ginir Town,85,86,16,187
Megabit,7th,2011,Oromia,Bale,Gasera,35,75,89,199
Sene,10th,2009,Oromia,West Arsi,Dodola Town,82,36,66,184
Megabit,7th,2011,Oromia,East Hararge,Haromaya Town,6,43,80,129
Megabit,7th,2009,Oromia,East Hararge,Chinakesen,5,48,59,112
Hedar,3rd,2011,Oromia,West Wellega,Kundala,53,3,52,108
Hedar,3rd,2011,Oromia,West Shewa,Codi,67,17,45,129
Miyazia,8th,2009,Oromia,East Shewa,Adami Tulu Jido Kombolcha,79,34,40,153
Miyazia,8th,2010,Oromia,Bale,Raitu,73,82,50,205
Tahesas,4th,2011,Oromia,East Hararge,Haromaya Hospital,94,2,80,176
Sene,10th,2010,Oromia,Ilu Aba Bora,Nono Sele,61,86,76,223
Megabit,7th,2011,Oromia,West Hararge,Chiro Town,29,91,33,153
Hamle,11th,2009,Oromia,East Wellega,Sasiga,98,99,38,235
Meskerem,1st,2010,Oromia,Gelan Town,Gelan Town,21,23,15,59
Nehase,12th,2010,Oromia,West Arsi,Gambo Hospital,35,2,97,134
Ginbot,9th,2011,Oromia,Borena,Arero,64,1,20,85
Miyazia,8th,2010,Oromia,Ilu Aba Bora,Yayu,12,38,95,145
Meskerem,1st,2011,Oromia,West Shewa,Midakegni,47,77,26,150
Sene,10th,2009,Oromia,West Shewa,Codi,77,73,47,197
Hedar,3rd,2010,Oromia,East Hararge,Chinakesen,34,82,11,127
Sene,10th,2011,Oromia,West Guji,Dugda Dawa,14,18,86,118
Ginbot,9th,2010,Oromia,East Shewa,Batu,92,81,60,233
Hedar,3rd,2011,Oromia,West Hararge,Mesela,10,91,43,144
Hedar,3rd,2011,Oromia,Qeleme Wellega,Gidami,76,81,98,255
Teqemt,2nd,2010,Oromia,Arsi,Merti,61,97,35,193
Tahesas,4th,2011,Oromia,Horo Gudru Wellega,Shambu Hospital,76,19,65,160
Megabit,7th,2011,Oromia,Arsi,Merti,83,41,34,158
Ginbot,9th,2009,Oromia,East Wellega,Limu,68,89,92,249
Hedar,3rd,2011,Oromia,Qeleme Wellega,Dambi Dolo Hospital,65,95,80,240
Ginbot,9th,2010,Oromia,Bishoftu Town,Bishoftu Town,78,37,19,134
Megabit,7th,2009,Oromia,Bale,Sinana,90,65,26,181
Yekatit,6th,2011,Oromia,East Hararge,Aweday Town,73,26,2,101
Teqemt,2nd,2010,Oromia,Buno Bedele,Diga,96,57,66,219
Tir,5th,2009,Oromia,West Shewa,Codi,12,31,41,84
Hedar,3rd,2010,Oromia,West Hararge,Chiro Zuriya,31,20,49,100
Meskerem,1st,2011,Oromia,East Hararge,Garemuleta Hospital,97,70,89,256
Hamle,11th,2010,Oromia,Buno Bedele,Diga,4,60,83,147
Yekatit,6th,2009,Oromia,Qeleme Wellega,Yemalogi Wolel,50,46,8,104
Ginbot,9th,2009,Oromia,West Wellega,Gimbi Adventist Hospital,62,54,83,199
Tir,5th,2011,Oromia,West Arsi,Nensebo,70,89,36,195
Ginbot,9th,2009,Oromia,West Guji,Kercha,25,15,57,97
Ginbot,9th,2011,Oromia,West Shewa,Dendi,53,92,94,239
Hedar,3rd,2011,Oromia,Qeleme Wellega,Kake Hosp,99,87,61,247
Megabit,7th,2009,Oromia,West Shewa,Midakegni,19,76,91,186
Tir,5th,2011,Oromia,West Shewa,Ginde Beret,32,26,48,106
Hamle,11th,2010,Oromia,Holeta Town,Holeta Town,59,48,98,205
Miyazia,8th,2011,Oromia,West Guji,Gelana,63,93,46,202
Ginbot,9th,2011,Oromia,Ilu Aba Bora,Yayu,94,2,92,188
Hamle,11th,2009,Oromia,West Shewa,Ambo Town,11,44,99,154
Ginbot,9th,2011,Oromia,Arsi,Robe,45,45,7,97
Ginbot,9th,2010,Oromia,West Guji,Dugda Dawa,33,95,32,160
Megabit,7th,2010,Oromia,West Hararge,Chiro Zuriya,99,4,47,150
Meskerem,1st,2010,Oromia,West Hararge,Anchar,8,87,97,192
Yekatit,6th,2009,Oromia,Dukem Town,Dukem Town,43,29,0,72
Yekatit,6th,2011,Oromia,Jimma,Agaro Hospital,89,32,58,179
Meskerem,1st,2010,Oromia,Bale,Goba,93,18,4,115
Miyazia,8th,2009,Oromia,Jimma,Tiro Afeta,71,28,30,129
Tir,5th,2011,Oromia,West Arsi,Kore,21,14,53,88
Yekatit,6th,2011,Oromia,Borena,Teltele,8,41,90,139
Teqemt,2nd,2011,Oromia,Bale,Seweyna,10,33,87,130
Miyazia,8th,2009,Oromia,East Hararge,Chinakesen,3,93,38,134
Ginbot,9th,2009,Oromia,Guji,Negele Town,30,48,0,78
Hedar,3rd,2010,Oromia,Bale,Ginir Town,16,64,12,92
Ginbot,9th,2011,Oromia,Bale,Meda Welabu,93,91,85,269
Sene,10th,2011,Oromia,Finfine Zuria,Mullo,89,58,76,223
Hamle,11th,2009,Oromia,West Arsi,Siraro,83,96,98,277
Yekatit,6th,2010,Oromia,Bale,Meda Welabu,20,77,48,145
Miyazia,8th,2010,Oromia,West Wellega,Begi,82,81,15,178
Tahesas,4th,2011,Oromia,Borena,Arero,47,52,89,188
Yekatit,6th,2009,Oromia,Lege Dadi Lege Tafo Town,Lege Dadi Lege Tafo Town,18,74,65,157
Ginbot,9th,2010,Oromia,South West Shewa,Dawo,96,57,75,228
Hedar,3rd,2010,Oromia,South West Shewa,Wonchi,25,88,94,207
Ginbot,9th,2011,Oromia,Guji,Anna Sora,32,58,20,110
Megabit,7th,2009,Oromia,Qeleme Wellega,Dale Wabera,72,72,4,148
Sene,10th,2010,Oromia,East Hararge,Babile Woreda,62,82,36,180
Megabit,7th,2011,Oromia,Buno Bedele,Dedesa,13,54,27,94
Hamle,11th,2010,Oromia,Buno Bedele,Gechi,17,91,29,137
Miyazia,8th,2011,Oromia,North Shewa,Wuchale,90,16,12,118
Sene,10th,2010,Oromia,North Shewa,Dera,25,63,17,105
Hedar,3rd,2011,Oromia,West Wellega,Begi,68,18,74,160
Yekatit,6th,2009,Oromia,West Wellega,Nejo Hospital,82,0,71,153
Ginbot,9th,2011,Oromia,Sululta Town,Sululta Town,9,62,49,120
Ginbot,9th,2011,Oromia,Horo Gudru Wellega,Shambu Hospital,53,43,38,134
Tir,5th,2009,Oromia,West Hararge,Doba,66,37,5,108
Nehase,12th,2010,Oromia,Finfine Zuria,Mullo,60,5,37,102
Hedar,3rd,2011,Oromia,Finfine Zuria,Walmera,4,22,38,64
Tir,5th,2010,Oromia,Ilu Aba Bora,Metu Town,14,61,0,75
Ginbot,9th,2010,Oromia,West Hararge,Chiro Hospital,68,62,60,190
Hedar,3rd,2010,Oromia,West Arsi,Nensebo,41,45,87,173
Ginbot,9th,2010,Oromia,Arsi,Seru,73,43,57,173
Tir,5th,2009,Oromia,Jimma,Seka Chekorsa,1,3,60,64
Tahesas,4th,2010,Oromia,West Arsi,Shashemene Rural,48,77,42,167
Tahesas,4th,2010,Oromia,East Hararge,Midega Tole,87,62,81,230
Megabit,7th,2009,Oromia,Borena,Wachile,80,6,99,185
Hedar,3rd,2010,Oromia,West Wellega,Genji,51,52,69,172
Teqemt,2nd,2010,Oromia,Borena,Moyale Hospital,37,14,51,102
Yekatit,6th,2010,Oromia,West Wellega,Seyo Nole,72,49,75,196
Yekatit,6th,2009,Oromia,East Shewa,Gimbichu,51,56,4,111
Megabit,7th,2010,Oromia,West Arsi,Wondo,93,85,31,209
Tahesas,4th,2011,Oromia,Jimma,Sekoru,86,13,23,122
Tir,5th,2011,Oromia,North Shewa,Yaya Gulele,90,66,84,240
Hedar,3rd,2011,Oromia,West Hararge,Chiro Zuriya,22,31,98,151
Sene,10th,2009,Oromia,Bale,Ginir Town,92,52,39,183
Sene,10th,2011,Oromia,Bale,Meda Welabu,79,94,40,213
Meskerem,1st,2010,Oromia,Arsi,Seru,15,9,39,63
Hedar,3rd,2010,Oromia,Bale,Dinsho,64,47,42,153
Hamle,11th,2010,Oromia,West Shewa,Abuna Gindeberet,57,72,22,151
Nehase,12th,2010,Oromia,Buno Bedele,Boricha,19,21,83,123
Nehase,12th,2009,Oromia,East Shewa,Adea,92,58,20,170
Hedar,3rd,2010,Oromia,South West Shewa,Seden Sodo,30,94,29,153
Tahesas,4th,2010,Oromia,Ambo Town,Ambo Town,25,74,6,105
Nehase,12th,2009,Oromia,West Hararge,Meiso,6,77,16,99
Yekatit,6th,2010,Oromia,Arsi,Enkelo Wabe,38,80,32,150
Megabit,7th,2009,Oromia,Borena,Meyo,95,90,5,190
Tahesas,4th,2011,Oromia,West Shewa,Ambo Hospital,34,61,81,176
Tir,5th,2009,Oromia,Horo Gudru Wellega,Horo,59,96,86,241
Hamle,11th,2010,Oromia,Jimma,Shabe,46,88,87,221
Hamle,11th,2010,Oromia,East Hararge,Deder Hospital,14,27,79,120
Megabit,7th,2011,Oromia,West Wellega,Nejo Town,10,55,87,152
Megabit,7th,2011,Oromia,West Guji,Bule Hora Toun,56,10,50,116
Miyazia,8th,2010,Oromia,West Arsi,Wondo,15,21,54,90
Hedar,3rd,2010,Oromia,West Wellega,Gimbi Adventist Hospital,99,62,96,257
Hedar,3rd,2011,Oromia,Guji,Negele Hospital,28,63,53,144
Tir,5th,2009,Oromia,West Guji,Kercha Hospital,88,18,71,177
Tahesas,4th,2010,Oromia,West Arsi,Kokosa,23,99,3,125
Tahesas,4th,2010,Oromia,Nekemte Town,Nekemte Town,12,73,16,101
Meskerem,1st,2011,Oromia,West Hararge,Daro Lebu,13,76,7,96
Sene,10th,2011,Oromia,Horo Gudru Wellega,Abe Dengoro,2,61,88,151
Tir,5th,2010,Oromia,West Wellega,Ayira Hospital,42,46,93,181
Hamle,11th,2010,Oromia,East Wellega,Wayu Tuqa,87,43,76,206
Teqemt,2nd,2011,Oromia,West Hararge,Gemechis,51,64,47,162
Megabit,7th,2009,Oromia,South West Shewa,Sodo Dac'Ha,10,16,33,59
Nehase,12th,2010,Oromia,West Hararge,Chiro Hospital,61,23,36,120
Sene,10th,2009,Oromia,Finfine Zuria,Sandefa,14,87,19,120
Hamle,11th,2010,Oromia,West Shewa,Jeldu,69,88,17,174
Nehase,12th,2010,Oromia,Qeleme Wellega,Gawo Qebe,0,35,0,35
Tir,5th,2009,Oromia,Finfine Zuria,Akaki,97,68,1,166
Tir,5th,2011,Oromia,Arsi,Chole,78,38,29,145
Hamle,11th,2009,Oromia,Borena,Moyale Hospital,84,22,16,122
Yekatit,6th,2009,Oromia,West Arsi,Arsi Negele Town,63,10,36,109
Tahesas,4th,2011,Oromia,Qeleme Wellega,Seyo,20,45,76,141
Miyazia,8th,2010,Oromia,Lege Dadi Lege Tafo Town,Lege Dadi Lege Tafo Town,71,59,44,174
Tahesas,4th,2010,Oromia,West Shewa,Jeldu,44,49,54,147
Miyazia,8th,2009,Oromia,West Shewa,Ambo Town,13,94,27,134
Tir,5th,2009,Oromia,Jimma,Gomma,88,32,89,209
Miyazia,8th,2009,Oromia,Horo Gudru Wellega,Abe Dengoro,84,73,28,185
Megabit,7th,2010,Oromia,West Hararge,Tulo,71,24,23,118
Ginbot,9th,2009,Oromia,East Wellega,Wama Hagelo,47,12,54,113
Nehase,12th,2009,Oromia,Finfine Zuria,Mullo,14,41,18,73
Yekatit,6th,2010,Oromia,West Wellega,Gimbi Adventist Hospital,16,84,61,161
Meskerem,1st,2010,Oromia,Ilu Aba Bora,Bilonopa,68,83,76,227
Nehase,12th,2009,Oromia,West Shewa,Elifata,45,81,25,151
Sene,10th,2010,Oromia,West Arsi,Kofele,72,57,0,129
Miyazia,8th,2009,Oromia,East Shewa,Matahara,46,90,2,138
Miyazia,8th,2011,Oromia,West Wellega,Gimbi Adventist Hospital,58,70,11,139
Sene,10th,2010,Oromia,West Shewa,Guder Hosp,24,34,22,80
Megabit,7th,2009,Oromia,Finfine Zuria,Walmera,85,40,16,141
Sene,10th,2010,Oromia,Finfine Zuria,Sululta Town,35,10,25,70
Meskerem,1st,2010,Oromia,West Wellega,Haru,18,81,86,185
Tir,5th,2010,Oromia,Gelan Town,Gelan Town,80,31,85,196
Ginbot,9th,2010,Oromia,West Arsi,Gambo Hospital,87,54,30,171
Yekatit,6th,2011,Oromia,East Shewa,Gimbichu,82,59,98,239
Megabit,7th,2010,Oromia,Ilu Aba Bora,Metu Town,55,25,32,112
Tir,5th,2011,Oromia,Robe Town,Robe Town,57,26,67,150
Megabit,7th,2009,Oromia,Gelan Town,Gelan Town,32,46,43,121
Yekatit,6th,2010,Oromia,West Wellega,Guliso,55,20,76,151
Nehase,12th,2009,Oromia,Guji,Negele Hospital,45,7,44,96
Teqemt,2nd,2011,Oromia,Guji,Saba Boru,36,53,57,146
Megabit,7th,2010,Oromia,West Hararge,Guba Qoricha,5,64,24,93
Teqemt,2nd,2011,Oromia,Guji,Liben,92,39,52,183
Megabit,7th,2009,Oromia,West Wellega,Nejo Town,95,27,29,151
Sene,10th,2009,Oromia,Ilu Aba Bora,Darimu,75,85,80,240
Tahesas,4th,2010,Oromia,West Wellega,Haru,26,72,74,172
Miyazia,8th,2009,Oromia,North Shewa,Dera Hospital,7,91,88,186
Ginbot,9th,2011,Oromia,East Hararge,Kombolicha,8,53,34,95
Sene,10th,2009,Oromia,West Guji,Bule Hora Hospital,98,64,20,182
Megabit,7th,2010,Oromia,Jimma,Chora Boter,19,32,54,105
Tir,5th,2011,Oromia,Arsi,Digeluna Tijo,88,31,79,198
Yekatit,6th,2010,Oromia,Guji,Aga Wayyu,6,14,77,97
Nehase,12th,2009,Oromia,Guji,Negele Town,53,66,97,216
Sene,10th,2011,Oromia,North Shewa,Were Jarso,77,89,29,195
Tahesas,4th,2010,Oromia,East Hararge,Deder Hospital,62,97,38,197
Hedar,3rd,2010,Oromia,West Shewa,Liban Jawi,21,30,85,136
Teqemt,2nd,2010,Oromia,Arsi,Seru,31,16,73,120
Tir,5th,2011,Oromia,Ilu Aba Bora,Metu Town,68,76,4,148
Yekatit,6th,2010,Oromia,West Wellega,Qiltu Kara,50,47,73,170
Ginbot,9th,2011,Oromia,West Wellega,Mendi Hospital,21,73,25,119
Hamle,11th,2010,Oromia,Finfine Zuria,Akaki,94,79,23,196
Sene,10th,2011,Oromia,East Hararge,Fedis,11,56,84,151
Teqemt,2nd,2011,Oromia,Arsi,Dodota,55,11,40,106
Miyazia,8th,2011,Oromia,Arsi,Tiyo,92,39,94,225
Tahesas,4th,2011,Oromia,West Guji,Dugda Dawa,49,50,24,123
Miyazia,8th,2009,Oromia,Arsi,Zeway Dugda,72,2,24,98
Miyazia,8th,2009,Oromia,West Guji,Gelana,89,60,66,215
Tir,5th,2010,Oromia,West Wellega,Nole Kaba,84,94,85,263
Miyazia,8th,2011,Oromia,Arsi,Tiyo,18,51,18,87
Miyazia,8th,2009,Oromia,West Wellega,Seyo Nole,17,15,5,37
